Type
copd.o1_GTCGCTATA.CTAGGTCCT.CTATTAGCC_1	COPD
copd.o1_GTCGCTATA.CAGCACTTC.TCCGTCTTA	COPD
copd.o1_ACACGCCGG.TCGTTAGCA.CTGTACGGA	COPD
copd.o1_CCTAGTATA.CAGAAATCG.GATCAGCGA	COPD
copd.o1_ATTGGCTAA.CTAGGTCCT.TGCATAGTA	COPD
copd.o1_ATTGGCTAA.CTAGGTCCT.ACTCATACG	COPD
copd.o1_ATTGGCTAA.AGGTTCGCT.CTCAAGACA	COPD
copd.o1_GGATTAGGA.AGGTTCGCT.GATGGTCCA	COPD
copd.o1_GGATTAGGA.CGCTAAGCA.ACAGGCTCC	COPD
copd.o1_ACATAAGCG.ACGCGAAGC.AAATGGAGG	COPD
copd.o1_CAGGTGTAG.TATAGCCCT.ATCGAGTCT	COPD
copd.o1_AGGAGATTA.CCGTATCTA.CACGATCCG	COPD
copd.o1_ACGGATATT.ACTATCCTC.ACAACTAGT	COPD
copd.o1_ACGGATATT.CAATTGATC.CAGGCATTT	COPD
copd.o1_ATTAAGTGC.TTGGTATGA.ACGTGGGAG	COPD
copd.o1_GCACTGTCA.TTGGAGGTA.CTCAAGACA	COPD
copd.o1_CGTTACTAA.ACCTGAGTC.AAGGGAACT	COPD
copd.o1_CAGCAAGAT.CTAGGTCCT.ATCATTCTG	COPD
copd.o1_AATATTGGG.TTGCGTACA.AGTAATTAG_1	COPD
copd.o1_TCCAGTCGA.ACTTGATGA.ATCATTCTG	COPD
copd.o1_ACACACAAA.GACACTTAA.GAACGACAA	COPD
copd.o1_ATCAGAGCT.GCATGGCTA.GGCTACAGA	COPD
copd.o1_AGCCCAATC.TCATCCTAA.CATAACGTT	COPD
copd.o1_CAGAATCGT.GGAATGATA.TCTACGACA	COPD
copd.o1_CAAAGTGTG.GACACTTAA.ACTCATACG_1	COPD
copd.o1_GAGCCAATA.CACCAGGTA.AACATCCAT	COPD
copd.o1_ATGTAATGG.ATTACCAAG.ACTCATACG	COPD
copd.o1_GAGTACATT.CAGTGCCCG.ATCGAGTCT	COPD
ctl.y1_GTCGCTATA.GAGTGCGAA.CACGATCCG	healthy
ctl.y1_CTTCACATA.TCATCCTAA.CAGGGAGGG	healthy
ctl.y1_CTTCACATA.AGAATGGAG.ACTCATACG	healthy
ctl.y1_AATCGAATG.AGAATGGAG.TCCTCAATA_2	healthy
ctl.y1_CCTAGTATA.GCCTGTTCA.CTAGATAGA	healthy
ctl.y1_ATTGGCTAA.ACGCGAAGC.AAGCCTTCT	healthy
ctl.y1_ATTGGCTAA.GGAATGATA.ACTTACGAT	healthy
ctl.y1_ATTGGCTAA.GGAATGATA.CTGTACGGA	healthy
ctl.y1_GTGTCCTTA.ACCAAAATG.ACTAGACCG	healthy
ctl.y1_GGATTAGGA.TTGGAGGTA.AAGGGAACT	healthy
ctl.y1_ATGGATCCA.CACCTACCC.CTGTACGGA	healthy
ctl.y1_ACATAAGCG.GATTCATCA.AATTACCGG	healthy
ctl.y1_ACCTTGCGG.ATTCATCGT.GCAACATTA	healthy
ctl.y1_AGGAGATTA.AGAGGACCA.TGTCTATCA	healthy
ctl.y1_ACCGGATAG.ATCAACCGA.CACGATCCG_1	healthy
ctl.y1_CCACTTGGA.AGGAGGCGC.TCAGATTCA	healthy
ctl.y1_GAATCTGTA.CACAAAGGC.GCAACATTA_1	healthy
ctl.y1_ACCAAGGAC.TAGAACACA.AGTTGCATC	healthy
ctl.y1_ACCAAGGAC.GCTAACTCA.ACGAACCAG	healthy
ctl.y1_CACACACTA.GTACATCTA.CATAACGTT	healthy
ctl.y1_CACACACTA.CAGCACTTC.GTAGAAGCA	healthy
ctl.y1_AAGTAACCC.ACAGTGGTA.AACGTGTGA	healthy
ctl.y1_AAATCCTGT.AGGCAGCTA.ATGGGACTC	healthy
ctl.y1_GCACTGTCA.CCGACAAGA.ACTCATACG	healthy
ctl.y1_GCACTGTCA.CACCTACCC.ACAAGTGCA	healthy
ctl.y1_GCACTGTCA.ACCAGGTGT.AAAGTCATT	healthy
ctl.y1_GCAATCCGA.AGGGCTGGT.TGTCTATCA	healthy
ctl.y1_GCAATCCGA.AAACGTACC.ATCGAGTCT	healthy
ctl.y1_GCAATCCGA.ATTACCAAG.GTCTTGGCA	healthy
ctl.y1_AACTTCTCC.TAGAACACA.AACGTGTGA	healthy
ctl.y1_TCTCTTCAA.AAACGTACC.ACAAGTGCA	healthy
ctl.y1_AGCACACAG.AAGGACTAT.GATGGTCCA	healthy
ctl.y1_ACAGTTCCG.TAGAACACA.ACTTACGAT	healthy
ctl.y1_AGTAAAGCC.GGAGTCTAA.AATGTATCG	healthy
ctl.y1_CGTTACTAA.CACCAGGTA.ACAAACTTT	healthy
ctl.y1_CAGCAAGAT.AAGCTACTT.CACAAGTAT	healthy
ctl.y1_CAAACCGCC.CCATGCACA.GTCTTGGCA	healthy
ctl.y1_AATATTGGG.GACACTTAA.ACGTGGGAG	healthy
ctl.y1_AATATTGGG.AGAATGGAG.CAATACAAG	healthy
ctl.y1_AATATTGGG.ACTTTAACT.ACGCTGTTG	healthy
ctl.y1_AATATTGGG.AAGGACTAT.CATAACGTT	healthy
ctl.y1_AGAACTTCC.ATCAACCGA.ACAGTAAAC	healthy
ctl.y1_CAAAGGCAC.GCTAACTCA.CTACATGCG_1	healthy
ctl.y1_AGAGCTATG.ACTATCCTC.CATGAATGA	healthy
ctl.y1_GAGGATGGA.AAGGACTAT.AATTACCGG	healthy
ctl.y1_ACACACAAA.AAACGTACC.GATCTCTTA	healthy
ctl.y1_ACACACAAA.ACTTGATGA.GAACGACAA	healthy
ctl.y1_ACACACAAA.AACCAAAGT.GCTCCTTGA	healthy
ctl.y1_ATCCCGGAG.CACTCGAGA.CACGATCCG	healthy
ctl.y1_TATGTGGCA.ACAATATGG.AGCTATGTG	healthy
ctl.y1_GCTGCCAAT.TAGGGATAC.CTACATGCG	healthy
ctl.y1_ATCAGAGCT.CTCTCTCAA.AGTAATTAG	healthy
ctl.y1_ATAGACGAG.CCGTATCTA.CTATCATGA	healthy
ctl.y1_ATCTCCACA.GTGTGTCGA.GATCTCTTA	healthy
ctl.y1_ATCTCCACA.GATGAACTG.CAATACAAG	healthy
ctl.y1_ACGAAAGGT.ACAGTGGTA.AGTAATTAG	healthy
ctl.y1_TAGCTTGTA.CACTTATGT.GTCTTGGCA	healthy
ctl.y1_ACACGAGAT.CAAGACCTA.GGCTACAGA_1	healthy
ctl.y1_ATTTAGATG.CGTTCGGTA.TACTTCGGA	healthy
ctl.y1_CCTGAGCAA.TTGGAGGTA.ACAACTAGT	healthy
copd.o2_GTCGCTATA.CACCAGGTA.AAGGCCGCA	COPD
copd.o2_GTCGCTATA.CTAGGTCCT.ACTTACGAT	COPD
copd.o2_GTCGCTATA.AAACGTACC.TGCATAGTA	COPD
copd.o2_GTCGCTATA.TTGGTATGA.ACAGTAAAC	COPD
copd.o2_GTCGCTATA.AGATAGTTC.AAAGAGGCC	COPD
copd.o2_GTCGCTATA.CAGCACTTC.TTAGGCATA	COPD
copd.o2_GTCGCTATA.AACCAAAGT.AAGGGAACT	COPD
copd.o2_CTTGTACTA.AATCCTGAA.CTCAAGACA_1	COPD
copd.o2_CTTGTACTA.TGACAGACA.AAATGGAGG_2	COPD
copd.o2_CTTGTACTA.ATTAGGCAT.ACAGGCTCC	COPD
copd.o2_CTTGTACTA.CCGACAAGA.TTCAGCTCA	COPD
copd.o2_CTTGTACTA.ACTATCCTC.ACTAGACCG	COPD
copd.o2_CTTCACATA.TGACAGACA.ACTAGACCG	COPD
copd.o2_CTTCACATA.TAGAACACA.ACAGTAAAC	COPD
copd.o2_CTTCACATA.TATAGCCCT.AACAACGCG	COPD
copd.o2_ACACGCCGG.TACAGGATA.AAATGGAGG	COPD
copd.o2_ACACGCCGG.ACGACCACC.ACACCTTAG	COPD
copd.o2_ACACGCCGG.TCATTGAGA.ACGAACCAG	COPD
copd.o2_ACACGCCGG.CAAGACCTA.TCCTCAATA	COPD
copd.o2_ACACGCCGG.AGAATGGAG.ATGGGACTC	COPD
copd.o2_ACACGCCGG.CTCTCTCAA.TCCTCAATA	COPD
copd.o2_ACACGCCGG.TTGGAGGTA.TCAGATTCA	COPD
copd.o2_CGGTCCAGG.CACCCAAAG.AGTAATTAG	COPD
copd.o2_CGGTCCAGG.CACCCAAAG.AAAGAGGCC	COPD
copd.o2_CGGTCCAGG.GACACTTAA.CTCAAGACA	COPD
copd.o2_CGGTCCAGG.GCCTGTTCA.ACAACTAGT	COPD
copd.o2_CGGTCCAGG.TAGAACACA.ACGCTGTTG_2	COPD
copd.o2_CGGTCCAGG.TCATTGAGA.AGCTATGTG	COPD
copd.o2_CGGTCCAGG.AACTCATTG.AAGCCTTCT	COPD
copd.o2_CGGTCCAGG.CACTTATGT.CGTACTACG	COPD
copd.o2_AATCGAATG.TGTGAAGAA.GCTATGGAA	COPD
copd.o2_AATCGAATG.ACAGTGGTA.TTAGGCATA	COPD
copd.o2_AATCGAATG.TCGTTAGCA.AAAGTCATT	COPD
copd.o2_AATCGAATG.TGTTCTCCA.CAATAGGGT	COPD
copd.o2_AATCGAATG.TAGTGACTA.AATGTATCG	COPD
copd.o2_AATCGAATG.ACAATATGG.ATGGTCCGT	COPD
copd.o2_CCTAGTATA.ACGACCACC.GGCACAACA	COPD
copd.o2_CCTAGTATA.TTCCATTGA.GCTATGGAA	COPD
copd.o2_CCTAGTATA.ACTGTTAGA.GTAGAAGCA	COPD
copd.o2_CCTAGTATA.AGGAGGCGC.ACGTGGGAG	COPD
copd.o2_CCTAGTATA.AAGAGTAGA.CAACCTCCA	COPD
copd.o2_ATTGGCTAA.CACCCAAAG.ATGGGACTC	COPD
copd.o2_ATTGGCTAA.ACCAAAATG.ACACCTTAG	COPD
copd.o2_ATTGGCTAA.TGACAGACA.CTACATGCG	COPD
copd.o2_ATTGGCTAA.AAATAAATA.AAGGGTCAG	COPD
copd.o2_ATTGGCTAA.CCGTATCTA.CTATCATGA	COPD
copd.o2_ATTGGCTAA.ACACATGTC.AATAAACAA	COPD
copd.o2_ATTGGCTAA.AGGATTCAA.CAAGTAGAA	COPD
copd.o2_ATTGGCTAA.ACTTTAACT.AAAGTCATT	COPD
copd.o2_ATTGGCTAA.CTTGCTTCA.GTAGAAGCA	COPD
copd.o2_ATTGGCTAA.GCATGGCTA.CTCAAGACA	COPD
copd.o2_ATTGGCTAA.AATTATAAC.GCAACATTA	COPD
copd.o2_AAGACATGC.ACAGTGGTA.TGTCTATCA	COPD
copd.o2_AAGACATGC.AAGCTACTT.CAACCTCCA	COPD
copd.o2_AAGACATGC.AGGGCTGGT.CAGGCATTT	COPD
copd.o2_AAGACATGC.TAGTGACTA.TCCTCAATA	COPD
copd.o2_AAGACATGC.ATTACCAAG.CAGGCATTT_1	COPD
copd.o2_AAGACATGC.AGGCAGCTA.GTTAGCCTA	COPD
copd.o2_AAGGCGATC.ATCCTAGGA.AAAGAGGCC	COPD
copd.o2_AAGGCGATC.ACTGTTAGA.AGCCGCAAG	COPD
copd.o2_AAGGCGATC.TTGCGTACA.AGCTATGTG_2	COPD
copd.o2_AAGGCGATC.ACGATGAAT.GGCTACAGA	COPD
copd.o2_AAGGCGATC.GGAATGATA.GGTTGGACA	COPD
copd.o2_AAGGCGATC.GCTAACTCA.CGTCTAGGT	COPD
copd.o2_AAGGCGATC.CCATGCACA.AACAGAAAC	COPD
copd.o2_AAGGCGATC.AGATAGTTC.CTCAAGACA	COPD
copd.o2_AAGGCGATC.AGTGAAAGG.CAGCCTGGC	COPD
copd.o2_GTGTCCTTA.CACAAAGGC.ACAGGCTCC	COPD
copd.o2_GTGTCCTTA.AAGCTACTT.AAATTACAG	COPD
copd.o2_GTGTCCTTA.TGACAGACA.CATAACGTT	COPD
copd.o2_GTGTCCTTA.TCATTGAGA.TGAAGCCAA	COPD
copd.o2_GTGTCCTTA.CAAGACCTA.TTAGGCATA	COPD
copd.o2_GTGTCCTTA.CCGTATCTA.CAAGTAGAA	COPD
copd.o2_GTGTCCTTA.GCTAACTCA.ATATTGTAA	COPD
copd.o2_GTGTCCTTA.CCATGCACA.AATAAACAA	COPD
copd.o2_GTGTCCTTA.AAACTGCGC.GAACGACAA	COPD
copd.o2_GTGTCCTTA.AGTGAAAGG.TTCAGCTCA	COPD
copd.o2_GTGTCCTTA.CGCTAAGCA.ATCATTCTG	COPD
copd.o2_GGATTAGGA.CTAGGTCCT.TCTCACGGA	COPD
copd.o2_GGATTAGGA.AGCGACACC.TCTCACGGA	COPD
copd.o2_GGATTAGGA.TTGGAGGTA.CAGCCTGGC	COPD
copd.o2_GGATTAGGA.CCATGCACA.CACAAGTAT	COPD
copd.o2_GGATTAGGA.CCATGCACA.GGCACAACA	COPD
copd.o2_GGATTAGGA.CTTGCTTCA.ACAACTAGT	COPD
copd.o2_GGATTAGGA.CGTTCGGTA.ACAAACTTT	COPD
copd.o2_GGATTAGGA.ACAATATGG.GTTAGCCTA_2	COPD
copd.o2_GGATTAGGA.AGTGAAAGG.AGCTATGTG	COPD
copd.o2_GGATTAGGA.AGTGAAAGG.CACGATCCG	COPD
copd.o2_GGATTAGGA.CGCTAAGCA.CAGGGAGGG	COPD
copd.o2_ATGGATCCA.CACCCAAAG.GGCTACAGA	COPD
copd.o2_ATGGATCCA.TGACAGACA.ATGGGACTC	COPD
copd.o2_ATGGATCCA.ATTAGGCAT.ACAAACTTT	COPD
copd.o2_ATGGATCCA.TCATTGAGA.CAGGCATTT	COPD
copd.o2_ATGGATCCA.ACTATCCTC.AAATTACAG	COPD
copd.o2_ATGGATCCA.CTCTCTCAA.CAAGTTTCC	COPD
copd.o2_ATGGATCCA.GCATGGCTA.TCCGTCTTA	COPD
copd.o2_ATGGATCCA.AGAGGACCA.AACGTGTGA	COPD
copd.o2_ACATAAGCG.CACCCAAAG.AGTAATTAG	COPD
copd.o2_ACATAAGCG.CACAAAGGC.CGTCTAGGT_1	COPD
copd.o2_ACATAAGCG.ACTTCGAGC.GGTGAGTTA	COPD
copd.o2_ACATAAGCG.CCGACAAGA.TCCGTCTTA	COPD
copd.o2_ACATAAGCG.ACTTTAACT.ATATTGTAA	COPD
copd.o2_ACATAAGCG.ATCCAACCG.CATAACGTT	COPD
copd.o2_ACATAAGCG.CCATGCACA.CTCAAGACA	COPD
copd.o2_ACATAAGCG.CTTGCTTCA.ATGGGACTC	COPD
copd.o2_ACATAAGCG.CGTTCGGTA.AGTAATTAG	COPD
copd.o2_ACATAAGCG.AGATAGTTC.ACTGAATTC	COPD
copd.o2_ACATAAGCG.AGGCAGCTA.AGTAATTAG	COPD
copd.o2_AACTGTATT.CACAAAGGC.ATCATTCTG	COPD
copd.o2_AACTGTATT.ACAGTGGTA.AGTTGTTCT	COPD
copd.o2_AACTGTATT.CACCTACCC.TGAAGCCAA	COPD
copd.o2_AACTGTATT.CACTCGAGA.GTTAGCCTA	COPD
copd.o2_AACTGTATT.CTTGCTTCA.AGTTGCATC	COPD
copd.o2_ACCTTGCGG.TTGGTATGA.TACTTCGGA	COPD
copd.o2_ACCTTGCGG.AGAATGGAG.AAGGCCGCA	COPD
copd.o2_ACCTTGCGG.TAGTGACTA.TCCTCAATA	COPD
copd.o2_ACCTTGCGG.GCATGGCTA.CGTACTACG	COPD
copd.o2_ACCTTGCGG.AATTATAAC.CAATAGGGT	COPD
copd.o2_CAGGTGTAG.CACCCAAAG.AACATCCAT_2	COPD
copd.o2_CAGGTGTAG.GTGTGTCGA.TTAGGCATA	COPD
copd.o2_CAGGTGTAG.CAGAAATCG.TCTCGGTTA	COPD
copd.o2_AGGAGATTA.CACCCAAAG.AACGTGTGA	COPD
copd.o2_AGGAGATTA.ACACATGTC.ACTAGACCG	COPD
copd.o2_AGGAGATTA.CTCTCTCAA.ACAGGCTCC	COPD
copd.o2_GCGATTACA.GATTCATCA.AAGCCTTCT	COPD
copd.o2_GCGATTACA.CACAAAGGC.AATAAACAA	COPD
copd.o2_GCGATTACA.CAGAAATCG.GCTCCTTGA	COPD
copd.o2_GCGATTACA.TAGGGATAC.CTGTACGGA	COPD
copd.o2_GCGATTACA.AGGGCTGGT.AAGTTTACG	COPD
copd.o2_GCGATTACA.ATCCAACCG.CAACGATCT	COPD
copd.o2_GCGATTACA.GATGAACTG.CAACCTCCA_1	COPD
copd.o2_GCGATTACA.CAATTGATC.CTATCATGA	COPD
copd.o2_ACCGGATAG.TCGTTAGCA.TCTCACGGA	COPD
copd.o2_ACCGGATAG.TCATCCTAA.GCTCCTTGA_2	COPD
copd.o2_ACCGGATAG.ACTTCGAGC.AACATCCAT	COPD
copd.o2_ACCGGATAG.ATCAACCGA.CAATACAAG	COPD
copd.o2_CCACTTGGA.ACGACCACC.CAAGTAGAA	COPD
copd.o2_CCACTTGGA.CTCTCTCAA.TCCTCAATA	COPD
copd.o2_CCACTTGGA.ATCCAACCG.ACGCTGTTG	COPD
copd.o2_CCACTTGGA.AACTCATTG.AATTCGGCG	COPD
copd.o2_CCACTTGGA.ACCTGAGTC.CAATAGGGT_2	COPD
copd.o2_AGAGAAGTT.CACCAGGTA.AGTTGCATC_2	COPD
copd.o2_AGAGAAGTT.GATTCATCA.TCTCGGTTA_2	COPD
copd.o2_AGAGAAGTT.ACAGTGGTA.AAAGTCATT	COPD
copd.o2_AGAGAAGTT.AGCGACACC.AAGCCTTCT_1	COPD
copd.o2_AGAGAAGTT.GTACATCTA.AGCCTGGTT	COPD
copd.o2_AGAGAAGTT.ATTAGGCAT.ACTGAATTC	COPD
copd.o2_AGAGAAGTT.GTGCAGTAA.AAGGGAACT	COPD
copd.o2_AGAGAAGTT.AGGATTCAA.AAAGAGGCC	COPD
copd.o2_AGAGAAGTT.AAGGACTAT.GTCTTGGCA	COPD
copd.o2_TAAGTTCGA.TGTGAAGAA.ACTAGACCG	COPD
copd.o2_TAAGTTCGA.ACAGTGGTA.ATGGTCCGT	COPD
copd.o2_TAAGTTCGA.ATTCATCGT.AAGTTTACG	COPD
copd.o2_TAAGTTCGA.GTGCAGTAA.CAATAGGGT	COPD
copd.o2_TAAGTTCGA.CCATGCACA.AACGTGTGA	COPD
copd.o2_TAAGTTCGA.ATTACCAAG.TCCTCAATA	COPD
copd.o2_TAAGTTCGA.CAGCACTTC.GAACGACAA	COPD
copd.o2_TAAGTTCGA.AGGCAGCTA.TGCATAGTA	COPD
copd.o2_TAAGTTCGA.CAACAACGG.ATATTGTAA	COPD
copd.o2_ACGGATATT.GATTCATCA.AAAGTCATT	COPD
copd.o2_ACGGATATT.CTAGGTCCT.ACAAACTTT	COPD
copd.o2_ACGGATATT.CAGTGCCCG.GATCAGCGA	COPD
copd.o2_ACGGATATT.CCGTATCTA.ACAGTAAAC	COPD
copd.o2_ACGGATATT.GTGCAGTAA.ATCGAGTCT	COPD
copd.o2_ACGGATATT.TTGGAGGTA.CAAGTAGAA	COPD
copd.o2_ACGGATATT.ATTACCAAG.CTACATGCG	COPD
copd.o2_ACGGATATT.CACTCGAGA.ACAAGTGCA	COPD
copd.o2_ACGGATATT.GCATGGCTA.CACAAGTAT	COPD
copd.o2_ACGGATATT.ACCAGGTGT.AACAACGCG	COPD
copd.o2_ACGGATATT.AGCTGCCGT.CTAGATAGA	COPD
copd.o2_TGGCTCAGA.TGTGAAGAA.AGTCTGTAC	COPD
copd.o2_TGGCTCAGA.ACTTCGAGC.CAATAGGGT_2	COPD
copd.o2_TGGCTCAGA.CAAGACCTA.CTCAAGACA	COPD
copd.o2_TGGCTCAGA.ACTTGATGA.GTCTTGGCA	COPD
copd.o2_TGGCTCAGA.AGGTTCGCT.AACATCCAT	COPD
copd.o2_TGGCTCAGA.CAATTGATC.ACACCTTAG	COPD
copd.o2_TGGCTCAGA.CAGCACTTC.ACTCCAGGG	COPD
copd.o2_TGGCTCAGA.CACTTATGT.CGTCTAGGT	COPD
copd.o2_TGGCTCAGA.AGGCAGCTA.GTTAGCCTA	COPD
copd.o2_GAATCTGTA.CACCAGGTA.ATCATTCTG	COPD
copd.o2_GAATCTGTA.TGTGAAGAA.CGTACTACG	COPD
copd.o2_GAATCTGTA.GATTCATCA.AACATCCAT	COPD
copd.o2_GAATCTGTA.AGCGACACC.AAGGGTCAG	COPD
copd.o2_GAATCTGTA.ACGCGAAGC.ACACCTTAG	COPD
copd.o2_GAATCTGTA.AGTGTTGTC.CGTCTAGGT	COPD
copd.o2_GAATCTGTA.AAATAAATA.ATGGGACTC	COPD
copd.o2_GAATCTGTA.ACTATCCTC.GAACGACAA	COPD
copd.o2_ACCAAGGAC.GCCTGTTCA.CAATACAAG	COPD
copd.o2_ACCAAGGAC.CCATGCACA.CTAAGCTTC	COPD
copd.o2_ACCAAGGAC.ACCTGAGTC.AATTCGGCG	COPD
copd.o2_ACCAAGGAC.AGTGAAAGG.ACAACTAGT	COPD
copd.o2_ACCAAGGAC.GAGTGCGAA.CTGTACGGA	COPD
copd.o2_AGTATCTGT.CACCAGGTA.ACTCATACG	COPD
copd.o2_AGTATCTGT.CACAAAGGC.AACAACGCG	COPD
copd.o2_AGTATCTGT.TGTTCTCCA.ACAGGCTCC_1	COPD
copd.o2_AGTATCTGT.ACCAAAATG.TCCTCAATA	COPD
copd.o2_AGTATCTGT.TAGGGATAC.GCTATGGAA	COPD
copd.o2_AGTATCTGT.ATCCTAGGA.GATAGAGGA	COPD
copd.o2_AGTATCTGT.TTGGAGGTA.CTACATGCG	COPD
copd.o2_AGTATCTGT.CACTCGAGA.TTCAGCTCA	COPD
copd.o2_AGTATCTGT.CTTGCTTCA.TCTCGGTTA	COPD
copd.o2_AGTATCTGT.TATAGCCCT.ACACCTTAG	COPD
copd.o2_AGTATCTGT.AGTGAAAGG.AATGTATCG	COPD
copd.o2_AGTATCTGT.AACCAAAGT.ATCGAGTCT	COPD
copd.o2_CACACACTA.GGAATGATA.ACAGTAAAC	COPD
copd.o2_CACACACTA.CCGTATCTA.AATTACCGG	COPD
copd.o2_CACACACTA.AGAATGGAG.GAACGACAA_2	COPD
copd.o2_CACACACTA.TAGTGACTA.ACTACATAT	COPD
copd.o2_CACACACTA.ACCTGAGTC.CACAAGTAT	COPD
copd.o2_CACACACTA.AGGTTCGCT.AAATGGAGG	COPD
copd.o2_CACACACTA.GCATGGCTA.TGTATGCGA	COPD
copd.o2_CACACACTA.TATAGCCCT.TCCTCAATA_1	COPD
copd.o2_ATTAAGTGC.CACCAGGTA.TCTACGACA	COPD
copd.o2_ATTAAGTGC.TGTGAAGAA.ACAAACTTT	COPD
copd.o2_ATTAAGTGC.ATTCATCGT.ACAGTAAAC	COPD
copd.o2_ATTAAGTGC.AGGAGGCGC.CACGATCCG	COPD
copd.o2_ATTAAGTGC.ATTAGGCAT.AATTACCGG	COPD
copd.o2_ATTAAGTGC.TCATTGAGA.AATTACCGG	COPD
copd.o2_ATTAAGTGC.CAAGACCTA.AGCTATGTG	COPD
copd.o2_ATTAAGTGC.TTGGTATGA.CGTACTACG	COPD
copd.o2_ATTAAGTGC.ATCAACCGA.CTAAGCTTC	COPD
copd.o2_ATTAAGTGC.CCATGCACA.GCAACATTA	COPD
copd.o2_ATTAAGTGC.ATTACCAAG.CTCAAGACA	COPD
copd.o2_ATTAAGTGC.AGGTTCGCT.GGCACAACA	COPD
copd.o2_AAGTAACCC.TTCCATTGA.ACAAACTTT	COPD
copd.o2_AAGTAACCC.AGGATTCAA.GATCTCTTA_2	COPD
copd.o2_AAGTAACCC.CTCTCTCAA.AAGGGTCAG	COPD
copd.o2_AAGTAACCC.ATCAACCGA.CTATTAGCC	COPD
copd.o2_AAGTAACCC.AAGGACTAT.CATGAATGA	COPD
copd.o2_AAATCCTGT.ACAGTGGTA.ACGAACCAG	COPD
copd.o2_AAATCCTGT.CAGAAATCG.CAATACAAG	COPD
copd.o2_AAATCCTGT.AGTGTTGTC.TCCGTCTTA	COPD
copd.o2_AAATCCTGT.GCCTGTTCA.GATAGAGGA	COPD
copd.o2_AAATCCTGT.AAGAGTAGA.ACTTACGAT	COPD
copd.o2_AAATCCTGT.CAGCACTTC.AGCCGCAAG	COPD
copd.o2_CACATTGCA.TGTTCTCCA.AGCCTGGTT	COPD
copd.o2_CACATTGCA.AGTGTTGTC.CTATTAGCC_1	COPD
copd.o2_CACATTGCA.ACTGTTAGA.TACTTCGGA	COPD
copd.o2_CACATTGCA.ATTCATCGT.GTTAGCCTA	COPD
copd.o2_CACATTGCA.CCATGCACA.ACTACATAT	COPD
copd.o2_CACATTGCA.CGCTAAGCA.AATGTATCG	COPD
copd.o2_GCACTGTCA.AAGCTACTT.GTAGAAGCA	COPD
copd.o2_GCACTGTCA.GGAGTCTAA.ACAGTAAAC	COPD
copd.o2_GCACTGTCA.AGAATGGAG.CAATACAAG	COPD
copd.o2_GCACTGTCA.TAGTGACTA.ATGGTCCGT	COPD
copd.o2_GCACTGTCA.GCATGGCTA.TCCTCAATA	COPD
copd.o2_GCACTGTCA.AGAGGACCA.TCCTCAATA	COPD
copd.o2_GCACTGTCA.CAGCACTTC.CAGGGAGGG	COPD
copd.o2_GCACTGTCA.AACCAAAGT.AACATCCAT	COPD
copd.o2_GCACTGTCA.CGCTAAGCA.ACGTGGGAG	COPD
copd.o2_ATACTTAGG.CACCAGGTA.CATGAATGA	COPD
copd.o2_ATACTTAGG.CACCCAAAG.ACGAACCAG	COPD
copd.o2_ATACTTAGG.AGCGACACC.ACGTGGGAG	COPD
copd.o2_ATACTTAGG.AGTGTTGTC.TGTCTATCA	COPD
copd.o2_ATACTTAGG.AGGGCTGGT.TCTACGACA	COPD
copd.o2_ATACTTAGG.TTGCGTACA.TGAAGCCAA	COPD
copd.o2_ATACTTAGG.TGACAGACA.CTGTACGGA	COPD
copd.o2_ATACTTAGG.TAGAACACA.CTATCATGA	COPD
copd.o2_ATACTTAGG.CACCTACCC.CGTACTACG	COPD
copd.o2_ATACTTAGG.CCGTATCTA.CAAACGTGG	COPD
copd.o2_ATACTTAGG.ACAATATGG.GAACGACAA	COPD
copd.o2_GCAATCCGA.GTGTGTCGA.AAATTACAG	COPD
copd.o2_GCAATCCGA.TCGTTAGCA.TACTTCGGA	COPD
copd.o2_GCAATCCGA.AGGGCTGGT.CTGTACGGA	COPD
copd.o2_GCAATCCGA.GGAATGATA.CGTCTAGGT	COPD
copd.o2_GCAATCCGA.ACACATGTC.ACGTGGGAG	COPD
copd.o2_GCAATCCGA.CCATGCACA.AGTAATTAG	COPD
copd.o2_GCAATCCGA.AGGTTCGCT.TCTCGGTTA	COPD
copd.o2_GCAATCCGA.AGGTTCGCT.ACTAGACCG	COPD
copd.o2_GCAATCCGA.TACTAGTCA.AAAGTCATT	COPD
copd.o2_GCAATCCGA.CAACAACGG.GCTCCTTGA	COPD
copd.o2_ACGCAATCA.TTGCGTACA.AACGTGTGA	COPD
copd.o2_ACGCAATCA.GACCTTAGA.ATATTGTAA	COPD
copd.o2_ACGCAATCA.ACTATCCTC.AGTCTGTAC	COPD
copd.o2_ACGCAATCA.CTCTCTCAA.ACAAGTGCA	COPD
copd.o2_ACGCAATCA.AGGTTCGCT.ACAACTAGT	COPD
copd.o2_ACGCAATCA.CAATTGATC.CATAACGTT	COPD
copd.o2_ACGCAATCA.ACAATATGG.GTCTTGGCA	COPD
copd.o2_GAGTATTAG.CACCAGGTA.AGTTGCATC	COPD
copd.o2_GAGTATTAG.CTAGGTCCT.AATGTATCG	COPD
copd.o2_GAGTATTAG.TCATCCTAA.AAGGGTCAG_2	COPD
copd.o2_GAGTATTAG.AATCCTGAA.CATAACGTT	COPD
copd.o2_GAGTATTAG.AATCCTGAA.AGCCGCAAG	COPD
copd.o2_GAGTATTAG.ATTCATCGT.AATAAACAA	COPD
copd.o2_GAGTATTAG.AGGAGGCGC.CTACATGCG	COPD
copd.o2_GAGTATTAG.AGGAGGCGC.ATGGTCCGT	COPD
copd.o2_GAGTATTAG.ATTAGGCAT.TTAGGCATA	COPD
copd.o2_GAGTATTAG.TAGAACACA.AACAGAAAC	COPD
copd.o2_GAGTATTAG.ACTTGATGA.ATCATTCTG	COPD
copd.o2_GAGTATTAG.TAGTGACTA.ACGTGGGAG	COPD
copd.o2_GAGTATTAG.TAGTGACTA.GCTATGGAA	COPD
copd.o2_GAGTATTAG.CGTTCGGTA.AAGGGAACT	COPD
copd.o2_GAGTATTAG.ACAATATGG.AATTACCGG	COPD
copd.o2_GAGTATTAG.TACTAGTCA.CAATAGGGT	COPD
copd.o2_GACGGATTA.AGGGCTGGT.CAAACGTGG	COPD
copd.o2_GACGGATTA.ATCAACCGA.TTCAGCTCA_2	COPD
copd.o2_GACGGATTA.ACTTTAACT.CAGGCATTT	COPD
copd.o2_GACGGATTA.CAGCACTTC.GTCTTGGCA	COPD
copd.o2_GACGGATTA.TACTAGTCA.AGTCTGTAC	COPD
copd.o2_CAGCTGACA.TACAGGATA.ACTACATAT	COPD
copd.o2_CAGCTGACA.CACCAGGTA.TACTTCGGA	COPD
copd.o2_CAGCTGACA.GATTCATCA.CTAAGCTTC	COPD
copd.o2_CAGCTGACA.ACAGTGGTA.ATCATTCTG	COPD
copd.o2_CAGCTGACA.ACAGTGGTA.CAACCTCCA	COPD
copd.o2_CAGCTGACA.ATCCTAGGA.ACGAACCAG	COPD
copd.o2_CAGCTGACA.GACACTTAA.AAATTACAG	COPD
copd.o2_CAGCTGACA.GACACTTAA.CAAACGTGG	COPD
copd.o2_CAGCTGACA.GACACTTAA.CTAGATAGA	COPD
copd.o2_CAGCTGACA.AAGAGTAGA.CAACGATCT	COPD
copd.o2_CAGCTGACA.AGGATTCAA.ACTAGACCG	COPD
copd.o2_CAGCTGACA.AACTCATTG.AGTTGTTCT	COPD
copd.o2_CAGCTGACA.AAGGACTAT.GAACGACAA	COPD
copd.o2_CAGCTGACA.CAGCACTTC.CAACGATCT	COPD
copd.o2_CAACATATT.GATTCATCA.ACATTCGGC	COPD
copd.o2_CAACATATT.ACTATCCTC.TCTCACGGA	COPD
copd.o2_CAACATATT.ATGAGTTAC.TGTATGCGA	COPD
copd.o2_CAACATATT.ATTACCAAG.GATCTCTTA	COPD
copd.o2_CAACATATT.AACTCATTG.AAGGGTCAG	COPD
copd.o2_CAACATATT.AGATAGTTC.AAATTACAG	COPD
copd.o2_CAACATATT.GCATGGCTA.TCTACGACA	COPD
copd.o2_AACTTCTCC.ACAGTGGTA.ACATTCGGC	COPD
copd.o2_AACTTCTCC.TTCCATTGA.ATCGAGTCT	COPD
copd.o2_AACTTCTCC.TGACAGACA.ACGCTGTTG	COPD
copd.o2_AACTTCTCC.CGTTCGGTA.TACTTCGGA	COPD
copd.o2_AACTTCTCC.CGTTCGGTA.AATTACCGG	COPD
copd.o2_AACTTCTCC.CAATTGATC.ACGTGGGAG	COPD
copd.o2_AACTTCTCC.AGGCAGCTA.AAAGTCATT	COPD
copd.o2_CTATGAAAT.GTGTGTCGA.AAATTACAG_2	COPD
copd.o2_CTATGAAAT.CAGAAATCG.ACGCTGTTG	COPD
copd.o2_CTATGAAAT.TTGCGTACA.AAATTACAG	COPD
copd.o2_CTATGAAAT.GACACTTAA.ACGTGGGAG	COPD
copd.o2_CTATGAAAT.GCCTGTTCA.ACTAGACCG	COPD
copd.o2_CTATGAAAT.TGACAGACA.AAGCCTTCT_2	COPD
copd.o2_CTATGAAAT.GGAGTCTAA.CTGTACGGA	COPD
copd.o2_CTATGAAAT.CCGACAAGA.TTCAGCTCA	COPD
copd.o2_CTATGAAAT.GACCTTAGA.AAGTTTACG	COPD
copd.o2_CTATGAAAT.AGAATGGAG.CTAAGCTTC	COPD
copd.o2_CTATGAAAT.AGATAGTTC.TCCTCAATA	COPD
copd.o2_CTATGAAAT.AGGCAGCTA.GTAGAAGCA	COPD
copd.o2_CTATGAAAT.AGGCAGCTA.TCAGATTCA	COPD
copd.o2_ATTATTACC.TCGTTAGCA.CTCAAGACA	COPD
copd.o2_ATTATTACC.AAATAAATA.ATATTGTAA	COPD
copd.o2_ATTATTACC.CCGACAAGA.GGCACAACA	COPD
copd.o2_ATTATTACC.AAGAGTAGA.CGTCTAGGT	COPD
copd.o2_ATTATTACC.ATCAACCGA.ACAACTAGT	COPD
copd.o2_ATTATTACC.ACTTTAACT.GGCACAACA	COPD
copd.o2_ATTATTACC.GATGAACTG.AGTTGCATC_2	COPD
copd.o2_ATTATTACC.ACCTGAGTC.CTAGATAGA	COPD
copd.o2_ATTATTACC.AACCAAAGT.CAACCTCCA	COPD
copd.o2_ATTATTACC.CGCTAAGCA.CGTACTACG	COPD
copd.o2_TACCGAGCA.AGTGTTGTC.TGAAGCCAA	COPD
copd.o2_TACCGAGCA.CCGTATCTA.AATTACCGG	COPD
copd.o2_TACCGAGCA.AAACTGCGC.AATTACCGG	COPD
copd.o2_TCTCTTCAA.TCGTTAGCA.GATGGTCCA	COPD
copd.o2_TCTCTTCAA.AGGGCTGGT.ATCGAGTCT	COPD
copd.o2_TCTCTTCAA.ATCCTAGGA.AGTTGTTCT	COPD
copd.o2_TCTCTTCAA.TAGAACACA.CAGGGAGGG	COPD
copd.o2_TCTCTTCAA.AGGATTCAA.TCTACGACA	COPD
copd.o2_TCTCTTCAA.AGAATGGAG.CTACATGCG	COPD
copd.o2_TCTCTTCAA.AAGGACTAT.GATAGAGGA	COPD
copd.o2_TCTCTTCAA.CACTTATGT.CTACATGCG_1	COPD
copd.o2_TCTCTTCAA.AGTGAAAGG.AACATCCAT	COPD
copd.o2_TCTCTTCAA.GAGTGCGAA.ATATTGTAA	COPD
copd.o2_TCTCTTCAA.TACTAGTCA.CTAAGCTTC	COPD
copd.o2_TAAGCGTTA.TACAGGATA.AATTACCGG	COPD
copd.o2_TAAGCGTTA.CTAGGTCCT.GATCAGCGA	COPD
copd.o2_TAAGCGTTA.AATCCTGAA.ACTCATACG	COPD
copd.o2_TAAGCGTTA.TTGCGTACA.ACACCTTAG	COPD
copd.o2_TAAGCGTTA.GTACATCTA.GTTAGCCTA	COPD
copd.o2_TAAGCGTTA.TGACAGACA.GATCTCTTA	COPD
copd.o2_TAAGCGTTA.CACCTACCC.TGTATGCGA	COPD
copd.o2_TAAGCGTTA.GCTAACTCA.GTAGAAGCA	COPD
copd.o2_TAAGCGTTA.ATCCAACCG.CGTCTAGGT	COPD
copd.o2_TAAGCGTTA.AGGTTCGCT.CACGATCCG	COPD
copd.o2_GCCTTACAA.TCATCCTAA.CGTCTAGGT	COPD
copd.o2_GCCTTACAA.TGACAGACA.ACTCATACG	COPD
copd.o2_GCCTTACAA.ATTAGGCAT.GGCACAACA	COPD
copd.o2_GCCTTACAA.AAACGTACC.GCAACATTA	COPD
copd.o2_GCCTTACAA.CCATGCACA.AGTCTGTAC	COPD
copd.o2_GCCTTACAA.TATAGCCCT.ATATTGTAA	COPD
copd.o2_GCCTTACAA.TATAGCCCT.ACTCATACG	COPD
copd.o2_GCCTTACAA.CACTTATGT.CATAACGTT	COPD
copd.o2_GCCTTACAA.CGCTAAGCA.AACGTGTGA	COPD
copd.o2_AGCACACAG.CAGAAATCG.AATAAACAA	COPD
copd.o2_AGCACACAG.ACTGTTAGA.AAGGGTCAG	COPD
copd.o2_AGCACACAG.ATTCATCGT.TCAGATTCA	COPD
copd.o2_AGCACACAG.ACTTCGAGC.AACAACGCG	COPD
copd.o2_AGCACACAG.TTGCGTACA.ACATTCGGC	COPD
copd.o2_AGCACACAG.CACCTACCC.GGTTGGACA	COPD
copd.o2_AGCACACAG.AAGAGTAGA.ACAAACTTT	COPD
copd.o2_AGCACACAG.CCATGCACA.ACTGAATTC	COPD
copd.o2_AGCACACAG.TAGTGACTA.CAACGATCT	COPD
copd.o2_AGCACACAG.TATAGCCCT.CATGAATGA	COPD
copd.o2_ACAGTTCCG.AAGCTACTT.TGAAGCCAA	COPD
copd.o2_ACAGTTCCG.ACTGTTAGA.ACAGGCTCC	COPD
copd.o2_ACAGTTCCG.GACACTTAA.GATCTCTTA	COPD
copd.o2_ACAGTTCCG.TGACAGACA.CAGCCTGGC	COPD
copd.o2_ACAGTTCCG.CAAGACCTA.CTATCATGA	COPD
copd.o2_ACAGTTCCG.ATCAACCGA.TCTACGACA	COPD
copd.o2_ACAGTTCCG.GATGAACTG.CGTCTAGGT	COPD
copd.o2_ACAGTTCCG.AACCCTCGG.ACAGTAAAC	COPD
copd.o2_AGTAAAGCC.AAGCTACTT.GATGGTCCA	COPD
copd.o2_AGTAAAGCC.TCATCCTAA.ACATTCGGC	COPD
copd.o2_AGTAAAGCC.GGAGTCTAA.ATATTGTAA	COPD
copd.o2_AGTAAAGCC.TAGAACACA.TCAGATTCA	COPD
copd.o2_AGTAAAGCC.TTGGTATGA.AAGGGTCAG	COPD
copd.o2_AGTAAAGCC.GATGAACTG.AAGGGTCAG	COPD
copd.o2_AGTAAAGCC.TAGTGACTA.CAAGTTTCC	COPD
copd.o2_AGTAAAGCC.CGTTCGGTA.AACGTGTGA	COPD
copd.o2_AGTAAAGCC.GCATGGCTA.GATAGAGGA	COPD
copd.o2_AGTAAAGCC.AACCCTCGG.AGCTATGTG	COPD
copd.o2_CAGTTTCAC.GATTCATCA.GTTAGCCTA	COPD
copd.o2_CAGTTTCAC.ACAGTGGTA.AACATCCAT	COPD
copd.o2_CAGTTTCAC.ACAGTGGTA.TCCTCAATA	COPD
copd.o2_CAGTTTCAC.CAGAAATCG.CTATTAGCC	COPD
copd.o2_CAGTTTCAC.ACTGTTAGA.ACAGGCTCC	COPD
copd.o2_CAGTTTCAC.AGGAGGCGC.AGTTGCATC	COPD
copd.o2_CAGTTTCAC.ATTAGGCAT.AACATCCAT	COPD
copd.o2_CAGTTTCAC.TCATTGAGA.GCAACATTA	COPD
copd.o2_CAGTTTCAC.CAAGACCTA.ACTCATACG	COPD
copd.o2_CAGTTTCAC.ACTTGATGA.CAACGATCT	COPD
copd.o2_CAGTTTCAC.ATCCAACCG.ACAAACTTT	COPD
copd.o2_CAGTTTCAC.CCATGCACA.AAAGTCATT	COPD
copd.o2_CAGTTTCAC.CCATGCACA.ACAGGCTCC	COPD
copd.o2_CAGTTTCAC.AGATAGTTC.TGTATGCGA	COPD
copd.o2_CAGTTTCAC.AACCCTCGG.AATTACCGG	COPD
copd.o2_CAGTTTCAC.AGGCAGCTA.GGTTGGACA	COPD
copd.o2_CGTTACTAA.TCGTTAGCA.ATGGTCCGT	COPD
copd.o2_CGTTACTAA.TGTTCTCCA.CAATACAAG	COPD
copd.o2_CGTTACTAA.ACTTCGAGC.GCTCCTTGA	COPD
copd.o2_CGTTACTAA.ATTAGGCAT.ACGCTGTTG	COPD
copd.o2_CGTTACTAA.CACCTACCC.ACAGGCTCC	COPD
copd.o2_CGTTACTAA.AGGATTCAA.ACTCATACG	COPD
copd.o2_CGTTACTAA.GCTAACTCA.AAAGAGGCC	COPD
copd.o2_CGTTACTAA.AACTCATTG.CTACATGCG	COPD
copd.o2_CGTTACTAA.CTTGCTTCA.GGCACAACA	COPD
copd.o2_CGTTACTAA.CACTTATGT.GAACGACAA	COPD
copd.o2_TTGTTCCAA.ACGACCACC.TCTACGACA	COPD
copd.o2_TTGTTCCAA.ACGATGAAT.GGCTACAGA	COPD
copd.o2_TTGTTCCAA.TGACAGACA.ACGCTGTTG	COPD
copd.o2_TTGTTCCAA.TAGAACACA.AAGGCCGCA	COPD
copd.o2_TTGTTCCAA.ATCCAACCG.ACAACTAGT_2	COPD
copd.o2_TTGTTCCAA.ATTACCAAG.ACAACTAGT	COPD
copd.o2_TTGTTCCAA.CTTGCTTCA.TGAAGCCAA	COPD
copd.o2_AGAAGCACT.TACAGGATA.AAGGGAACT	COPD
copd.o2_AGAAGCACT.CAGTGCCCG.TGTATGCGA	COPD
copd.o2_AGAAGCACT.CTCTCTCAA.TGTATGCGA_1	COPD
copd.o2_AGAAGCACT.CACTCGAGA.GAACGACAA	COPD
copd.o2_AGAAGCACT.AGGTTCGCT.GCTCCTTGA	COPD
copd.o2_AGAAGCACT.ACCAGGTGT.AGTTGCATC	COPD
copd.o2_AGAAGCACT.AGGCAGCTA.AACAGAAAC	COPD
copd.o2_AGAAGCACT.CAACAACGG.TCCTCAATA	COPD
copd.o2_CAGCAAGAT.TGTTCTCCA.CACGATCCG	COPD
copd.o2_CAGCAAGAT.TAGAACACA.CAACCTCCA	COPD
copd.o2_CAGCAAGAT.AAATAAATA.ATGGTCCGT	COPD
copd.o2_CAGCAAGAT.CACCTACCC.ATGGGACTC	COPD
copd.o2_CAGCAAGAT.TAGTGACTA.AATGTATCG	COPD
copd.o2_CAGCAAGAT.CTTGCTTCA.CAACGATCT	COPD
copd.o2_CAGCAAGAT.AGATAGTTC.CAGCCTGGC	COPD
copd.o2_CAGCAAGAT.AGCTGCCGT.GATGGTCCA	COPD
copd.o2_CAAACCGCC.TGTTCTCCA.GATAGAGGA	COPD
copd.o2_CAAACCGCC.ACTGTTAGA.GGCACAACA	COPD
copd.o2_CAAACCGCC.AATCAGTTT.TCCGTCTTA_1	COPD
copd.o2_CAAACCGCC.AATCAGTTT.AATAAACAA	COPD
copd.o2_CAAACCGCC.GGAGTCTAA.GCTATGGAA	COPD
copd.o2_CAAACCGCC.GTGCAGTAA.TCAGATTCA	COPD
copd.o2_CAAACCGCC.ATCCAACCG.CATAACGTT	COPD
copd.o2_CAAACCGCC.CTTGCTTCA.AGTCTGTAC	COPD
copd.o2_CAAACCGCC.AGCTGCCGT.GGCTACAGA_2	COPD
copd.o2_CAAACCGCC.CAGCACTTC.AGCCGCAAG	COPD
copd.o2_CTAACTCGC.CAGAAATCG.GGCTACAGA	COPD
copd.o2_CTAACTCGC.CAGTGCCCG.GGCTACAGA	COPD
copd.o2_CTAACTCGC.ATGAGTTAC.TCTCGGTTA	COPD
copd.o2_AATATTGGG.CACCCAAAG.CTGTACGGA	COPD
copd.o2_AATATTGGG.CACCCAAAG.ACTAGACCG	COPD
copd.o2_AATATTGGG.ACAGTGGTA.CAGGCATTT	COPD
copd.o2_AATATTGGG.AGCGACACC.ACTCCAGGG	COPD
copd.o2_AATATTGGG.TTCCATTGA.CAGCCTGGC	COPD
copd.o2_AATATTGGG.ATTAGGCAT.AATAAACAA_1	COPD
copd.o2_AATATTGGG.GACCTTAGA.AAAGTCATT	COPD
copd.o2_AATATTGGG.AGGATTCAA.GCTATGGAA	COPD
copd.o2_AATATTGGG.GCTAACTCA.ATATTGTAA	COPD
copd.o2_AATATTGGG.CCATGCACA.ACGTGGGAG	COPD
copd.o2_AATATTGGG.ACCAGGTGT.ACTCCAGGG	COPD
copd.o2_AATATTGGG.TATAGCCCT.AGCTATGTG	COPD
copd.o2_AATATTGGG.AGGCAGCTA.CTAGATAGA	COPD
copd.o2_AGAACTTCC.CACCCAAAG.CAACCTCCA	COPD
copd.o2_AGAACTTCC.ACTTCGAGC.ACTTACGAT	COPD
copd.o2_AGAACTTCC.TTGCGTACA.CATAACGTT	COPD
copd.o2_AGAACTTCC.ATTAGGCAT.GATGGTCCA	COPD
copd.o2_AGAACTTCC.TCATTGAGA.GCAACATTA	COPD
copd.o2_AGAACTTCC.TTGGAGGTA.GGTTGGACA	COPD
copd.o2_AGAACTTCC.CAATTGATC.ACATTCGGC	COPD
copd.o2_CAAAGGCAC.CACCCAAAG.CAAGTTTCC	COPD
copd.o2_CAAAGGCAC.AATCCTGAA.ACGCTGTTG	COPD
copd.o2_CAAAGGCAC.CACCTACCC.ACTTACGAT	COPD
copd.o2_CAAAGGCAC.GGAATGATA.TGAAGCCAA	COPD
copd.o2_CAAAGGCAC.TATAGCCCT.CTATTAGCC	COPD
copd.o2_CAAAGGCAC.AACCAAAGT.ACAGTAAAC	COPD
copd.o2_CAAAGGCAC.CGCTAAGCA.AAAGTCATT	COPD
copd.o2_CAAAGGCAC.AATTATAAC.TCAGATTCA	COPD
copd.o2_CAAAGGCAC.TACTAGTCA.ATATTGTAA	COPD
copd.o2_AAGCTCAAC.ACGCGAAGC.CAACGATCT	COPD
copd.o2_AAGCTCAAC.TTCCATTGA.AATGTATCG	COPD
copd.o2_AAGCTCAAC.CCGACAAGA.CAGGGAGGG	COPD
copd.o2_AAGCTCAAC.TCATTGAGA.GGCTACAGA	COPD
copd.o2_AAGCTCAAC.CAAGACCTA.ATGGGACTC	COPD
copd.o2_AAGCTCAAC.CACTCGAGA.AAGTTTACG	COPD
copd.o2_AAGCTCAAC.AACTCATTG.AAAGAGGCC_2	COPD
copd.o2_AAGCTCAAC.AGATAGTTC.CAAGTTTCC_1	COPD
copd.o2_AAGCTCAAC.AGCTGCCGT.AAATGGAGG	COPD
copd.o2_AAGCTCAAC.ACAATATGG.ACTCATACG	COPD
copd.o2_AAGCTCAAC.CAACAACGG.ACTGAATTC	COPD
copd.o2_TCCAGTCGA.ACTGTTAGA.GGCACAACA	COPD
copd.o2_TCCAGTCGA.AATCAGTTT.AAGGGTCAG_2	COPD
copd.o2_TCCAGTCGA.ATTAGGCAT.ACTACATAT	COPD
copd.o2_TCCAGTCGA.AAATAAATA.ACATTCGGC	COPD
copd.o2_TCCAGTCGA.AAATAAATA.CGTCTAGGT	COPD
copd.o2_TCCAGTCGA.GACCTTAGA.ACAGTAAAC	COPD
copd.o2_TCCAGTCGA.AAACGTACC.ATGGGACTC	COPD
copd.o2_TCCAGTCGA.ATTACCAAG.AAGCCTTCT	COPD
copd.o2_TCCAGTCGA.ACAATATGG.AATTCGGCG	COPD
copd.o2_TCCAGTCGA.CACTTATGT.CGTCTAGGT	COPD
copd.o2_TCCAGTCGA.AACCAAAGT.GCTCCTTGA	COPD
copd.o2_AGCCATCAC.GATTCATCA.ACAGTAAAC	COPD
copd.o2_AGCCATCAC.AGTGTTGTC.GCTATGGAA	COPD
copd.o2_AGCCATCAC.TCATTGAGA.AATAAACAA	COPD
copd.o2_AGCCATCAC.GACCTTAGA.ATCGAGTCT	COPD
copd.o2_AGCCATCAC.CCATGCACA.TTCAGCTCA	COPD
copd.o2_AGCCATCAC.AGAGGACCA.ACGTGGGAG	COPD
copd.o2_AACGAGAAG.ATTCATCGT.GGTTGGACA	COPD
copd.o2_AACGAGAAG.ACTTCGAGC.ATGGTCCGT	COPD
copd.o2_AACGAGAAG.AAGAGTAGA.TGTATGCGA	COPD
copd.o2_AACGAGAAG.TCATTGAGA.AAATTACAG	COPD
copd.o2_AACGAGAAG.AGGATTCAA.TCTCACGGA_2	COPD
copd.o2_AACGAGAAG.AGAATGGAG.CAACGATCT	COPD
copd.o2_AACGAGAAG.ACTTTAACT.CAACCTCCA	COPD
copd.o2_AACGAGAAG.TTGGAGGTA.AATAAACAA	COPD
copd.o2_AACGAGAAG.ATCCAACCG.AAAGAGGCC	COPD
copd.o2_AACGAGAAG.TAGTGACTA.AAGGGAACT	COPD
copd.o2_AACGAGAAG.ACCTGAGTC.ACAACTAGT	COPD
copd.o2_AACGAGAAG.TATAGCCCT.CAGCCTGGC	COPD
copd.o2_AACGAGAAG.CAGCACTTC.CAGGGAGGG	COPD
copd.o2_AACGAGAAG.AACCCTCGG.AAGGGTCAG	COPD
copd.o2_CTACAGAAC.CACCCAAAG.ACTGAATTC	COPD
copd.o2_CTACAGAAC.TGTTCTCCA.ATCATTCTG	COPD
copd.o2_CTACAGAAC.ACTTCGAGC.ACTTACGAT	COPD
copd.o2_CTACAGAAC.GACACTTAA.TACTTCGGA	COPD
copd.o2_CTACAGAAC.AATCAGTTT.CAACGATCT	COPD
copd.o2_CTACAGAAC.GGAGTCTAA.ACTTACGAT	COPD
copd.o2_CTACAGAAC.CACCTACCC.GGTGAGTTA_1	COPD
copd.o2_CTACAGAAC.GGAATGATA.ACTACATAT_1	COPD
copd.o2_CTACAGAAC.CCGTATCTA.ACGTGGGAG	COPD
copd.o2_CTACAGAAC.ACTTTAACT.AATTACCGG	COPD
copd.o2_CTACAGAAC.CACTCGAGA.ACGAACCAG	COPD
copd.o2_CTACAGAAC.ACCAGGTGT.CTAGATAGA	COPD
copd.o2_CTACAGAAC.AGAGGACCA.TCCTCAATA	COPD
copd.o2_CTACAGAAC.CACTTATGT.ACATTCGGC	COPD
copd.o2_CTACAGAAC.TACTAGTCA.TTCAGCTCA	COPD
copd.o2_AGAGCTATG.TAGGGATAC.GCTATGGAA	COPD
copd.o2_AGAGCTATG.TCATCCTAA.AAGGGAACT	COPD
copd.o2_AGAGCTATG.CAAGACCTA.ACAGGCTCC	COPD
copd.o2_AGAGCTATG.AAACGTACC.ACAGTAAAC	COPD
copd.o2_AGAGCTATG.CCATGCACA.GTTAGCCTA	COPD
copd.o2_AGAGCTATG.CACTCGAGA.GCTATGGAA	COPD
copd.o2_AGAGCTATG.ACCTGAGTC.ACACCTTAG	COPD
copd.o2_AGAGCTATG.AGATAGTTC.CAAGTAGAA	COPD
copd.o2_AGAGCTATG.ACCAGGTGT.ACTCATACG_1	COPD
copd.o2_AGAGCTATG.TATAGCCCT.TGCATAGTA	COPD
copd.o2_AGAGCTATG.AGAGGACCA.GAACGACAA	COPD
copd.o2_GAGGATGGA.AGCGACACC.ACTAGACCG	COPD
copd.o2_GAGGATGGA.ACGATGAAT.AAATTACAG_1	COPD
copd.o2_GAGGATGGA.TGACAGACA.CAAGTTTCC	COPD
copd.o2_GAGGATGGA.AAGAGTAGA.TCCGTCTTA	COPD
copd.o2_GAGGATGGA.ACTATCCTC.GTTAGCCTA	COPD
copd.o2_GAGGATGGA.ACTATCCTC.AACGTGTGA_2	COPD
copd.o2_GAGGATGGA.AGGATTCAA.ACTAGACCG	COPD
copd.o2_GAGGATGGA.CACTTATGT.AGCTATGTG	COPD
copd.o2_GAGGATGGA.AGGCAGCTA.CAAACGTGG	COPD
copd.o2_GAGGATGGA.AACCAAAGT.GCTATGGAA	COPD
copd.o2_GAGGATGGA.GAGTGCGAA.CTATCATGA	COPD
copd.o2_GAGGATGGA.TACTAGTCA.CAACCTCCA	COPD
copd.o2_TGTACCTTA.CACAAAGGC.GGCACAACA	COPD
copd.o2_TGTACCTTA.ATCCTAGGA.CAACGATCT	COPD
copd.o2_TGTACCTTA.ACTTCGAGC.CGTACTACG	COPD
copd.o2_TGTACCTTA.GCTAACTCA.AGTTGCATC	COPD
copd.o2_ACACACAAA.CTAGGTCCT.AAGGGTCAG	COPD
copd.o2_ACACACAAA.AGGGCTGGT.CACGATCCG	COPD
copd.o2_ACACACAAA.GCCAATGTA.ATCATTCTG	COPD
copd.o2_ACACACAAA.GATGAACTG.TGTCTATCA	COPD
copd.o2_ACACACAAA.CTTGCTTCA.AGTTGCATC	COPD
copd.o2_ACACACAAA.CTTGCTTCA.CGTCTAGGT	COPD
copd.o2_ACACACAAA.AGATAGTTC.ATCATTCTG	COPD
copd.o2_ACACACAAA.AGCTGCCGT.CAGCCTGGC	COPD
copd.o2_ACACACAAA.TACTAGTCA.ACACCTTAG	COPD
copd.o2_TCAGGAGGA.ACTTCGAGC.CAAACGTGG	COPD
copd.o2_TCAGGAGGA.ACGATGAAT.TTCAGCTCA	COPD
copd.o2_TCAGGAGGA.TAGAACACA.ACGAACCAG	COPD
copd.o2_TCAGGAGGA.AAATAAATA.AACAACGCG	COPD
copd.o2_TCAGGAGGA.CACTCGAGA.AAGGCCGCA	COPD
copd.o2_TCAGGAGGA.AACTCATTG.CTACATGCG	COPD
copd.o2_TCAGGAGGA.CTTGCTTCA.AATTCGGCG	COPD
copd.o2_GAGGTGCTA.ACTTCGAGC.CAACGATCT	COPD
copd.o2_GAGGTGCTA.AATCAGTTT.ACAACTAGT	COPD
copd.o2_GAGGTGCTA.TAGAACACA.CAGGCATTT	COPD
copd.o2_GAGGTGCTA.CACTCGAGA.GATCAGCGA	COPD
copd.o2_GAGGTGCTA.CTTGCTTCA.CTATCATGA	COPD
copd.o2_ACCCTGACC.CACCAGGTA.CACAAGTAT	COPD
copd.o2_ACCCTGACC.TAGAACACA.CAAGTTTCC	COPD
copd.o2_ACCCTGACC.AAGAGTAGA.CTAGATAGA	COPD
copd.o2_ACCCTGACC.ACTATCCTC.AGTCTGTAC	COPD
copd.o2_ACCCTGACC.AGATAGTTC.AGCCGCAAG	COPD
copd.o2_ACAAGGATC.GATTCATCA.CAGCCTGGC	COPD
copd.o2_ACAAGGATC.CTAGGTCCT.ACAGGCTCC	COPD
copd.o2_ACAAGGATC.AATCCTGAA.TTAGGCATA	COPD
copd.o2_ACAAGGATC.AATCAGTTT.CAATAGGGT	COPD
copd.o2_ACAAGGATC.AGAATGGAG.AGTTGTTCT	COPD
copd.o2_ACAAGGATC.TAGTGACTA.AACGTGTGA	COPD
copd.o2_ACAAGGATC.AGTGAAAGG.AACAGAAAC	COPD
copd.o2_ATCCCGGAG.CTAGGTCCT.AGTTGTTCT	COPD
copd.o2_ATCCCGGAG.AGCGACACC.TCTCACGGA	COPD
copd.o2_ATCCCGGAG.AATCAGTTT.CTATTAGCC	COPD
copd.o2_ATCCCGGAG.ACTATCCTC.CAATAGGGT	COPD
copd.o2_ATCCCGGAG.CTCTCTCAA.GGTGAGTTA	COPD
copd.o2_ATCCCGGAG.CAGCACTTC.CAATAGGGT	COPD
copd.o2_TATGTGGCA.ACTATCCTC.AGTTGTTCT_1	COPD
copd.o2_TATGTGGCA.CTTGCTTCA.TCTCGGTTA	COPD
copd.o2_TATGTGGCA.ACCTGAGTC.AAGCCTTCT	COPD
copd.o2_TATGTGGCA.ACCTGAGTC.AAATGGAGG	COPD
copd.o2_TATGTGGCA.ACCAGGTGT.AAGCCTTCT	COPD
copd.o2_TATGTGGCA.AACCCTCGG.CAACGATCT	COPD
copd.o2_TATGTGGCA.AACCAAAGT.CACAAGTAT	COPD
copd.o2_GCTGCCAAT.GTGTGTCGA.AAGGCCGCA	COPD
copd.o2_GCTGCCAAT.ATCCTAGGA.ATATTGTAA	COPD
copd.o2_GCTGCCAAT.TTGCGTACA.ATATTGTAA	COPD
copd.o2_GCTGCCAAT.ATCAACCGA.AGCCTGGTT	COPD
copd.o2_GCTGCCAAT.GATGAACTG.CAAACGTGG	COPD
copd.o2_GCTGCCAAT.AACTCATTG.AAGCCTTCT	COPD
copd.o2_ATCAGAGCT.TAGGGATAC.GTAGAAGCA	COPD
copd.o2_ATCAGAGCT.CCGTATCTA.CTGTACGGA	COPD
copd.o2_ATCAGAGCT.AAACTGCGC.CTGTACGGA	COPD
copd.o2_ATCAGAGCT.CAATTGATC.CAAGTTTCC	COPD
copd.o2_ATCAGAGCT.ACCAGGTGT.TACTTCGGA	COPD
copd.o2_ATCAGAGCT.AACCCTCGG.ACATTCGGC	COPD
copd.o2_ATCAGAGCT.TACTAGTCA.CTAAGCTTC	COPD
copd.o2_TCGAAGTGA.CACAAAGGC.ATCATTCTG_2	COPD
copd.o2_TCGAAGTGA.TAGGGATAC.AATGTATCG	COPD
copd.o2_TCGAAGTGA.GGAATGATA.AGCTATGTG	COPD
copd.o2_TCGAAGTGA.AGGTTCGCT.TTAGGCATA	COPD
copd.o2_TCGAAGTGA.CAGCACTTC.AAGCCTTCT	COPD
copd.o2_TCGAAGTGA.AGGCAGCTA.ATCGAGTCT	COPD
copd.o2_TCGAAGTGA.TACTAGTCA.ACAACTAGT	COPD
copd.o2_ATAGACGAG.GATTCATCA.ATGGGACTC	COPD
copd.o2_ATAGACGAG.TTGCGTACA.AATTACCGG	COPD
copd.o2_ATAGACGAG.CAAGACCTA.AATGTATCG	COPD
copd.o2_ATAGACGAG.GATGAACTG.CAACCTCCA	COPD
copd.o2_ATAGACGAG.AAGGACTAT.ATATTGTAA	COPD
copd.o2_ATAGACGAG.CAACAACGG.CGTCTAGGT	COPD
copd.o2_AGCCCAATC.TAGTCTTGA.AATTACCGG	COPD
copd.o2_AGCCCAATC.CAGTGCCCG.AGCTATGTG	COPD
copd.o2_AGCCCAATC.ATTAGGCAT.AAATTACAG	COPD
copd.o2_AGCCCAATC.CCGACAAGA.CATGAATGA	COPD
copd.o2_AGCCCAATC.CCATGCACA.CAGGGAGGG	COPD
copd.o2_AGCCCAATC.CTTGCTTCA.CTACATGCG	COPD
copd.o2_AGCCCAATC.AACCCTCGG.GAACGACAA	COPD
copd.o2_CAGAATCGT.AGCGACACC.TCTACGACA	COPD
copd.o2_CAGAATCGT.AGCGACACC.GATGGTCCA	COPD
copd.o2_CAGAATCGT.GGAGTCTAA.CAAACGTGG	COPD
copd.o2_CAGAATCGT.AGGATTCAA.TTCAGCTCA	COPD
copd.o2_CAGAATCGT.ATCAACCGA.AATGTATCG	COPD
copd.o2_CAGAATCGT.GCCAATGTA.CTATTAGCC	COPD
copd.o2_CAGAATCGT.CAGCACTTC.CAGCCTGGC	COPD
copd.o2_CAGAATCGT.CAGCACTTC.ACATTCGGC	COPD
copd.o2_ATCTCCACA.CACAAAGGC.TGTATGCGA	COPD
copd.o2_ATCTCCACA.GTGTGTCGA.CTCAAGACA	COPD
copd.o2_ATCTCCACA.AGCGACACC.CAGGCATTT_2	COPD
copd.o2_ATCTCCACA.ACCAAAATG.CACGATCCG	COPD
copd.o2_ATCTCCACA.AGGGCTGGT.AAGCCTTCT	COPD
copd.o2_ATCTCCACA.TCATCCTAA.AGCCGCAAG	COPD
copd.o2_ATCTCCACA.TGACAGACA.CAGCCTGGC	COPD
copd.o2_ATCTCCACA.AAACGTACC.CAATACAAG	COPD
copd.o2_ATCTCCACA.GCTAACTCA.CTCAAGACA	COPD
copd.o2_ATCTCCACA.CACTCGAGA.ACTACATAT	COPD
copd.o2_ATCTCCACA.AGATAGTTC.AACAACGCG	COPD
copd.o2_ATCTCCACA.AGCTGCCGT.ATGGTCCGT	COPD
copd.o2_ACGAAAGGT.AAGCTACTT.AACAACGCG	COPD
copd.o2_ACGAAAGGT.ACCAAAATG.ACTAGACCG	COPD
copd.o2_ACGAAAGGT.GACACTTAA.AAGCCTTCT_1	COPD
copd.o2_ACGAAAGGT.TCATTGAGA.TCTACGACA	COPD
copd.o2_ACGAAAGGT.CCGTATCTA.ACAACTAGT	COPD
copd.o2_ACGAAAGGT.ATCAACCGA.CAGGGAGGG	COPD
copd.o2_ACGAAAGGT.ACTTGATGA.ACTAGACCG	COPD
copd.o2_ACGAAAGGT.ATCCAACCG.TCTACGACA	COPD
copd.o2_ACGAAAGGT.CCATGCACA.ACTAGACCG	COPD
copd.o2_ACGAAAGGT.AAGGACTAT.AATGTATCG	COPD
copd.o2_ACGAAAGGT.AAGGACTAT.ACAAACTTT	COPD
copd.o2_ACGAAAGGT.AGATAGTTC.ACACCTTAG	COPD
copd.o2_ACGAAAGGT.CACTTATGT.AGTTGTTCT	COPD
copd.o2_TAGCTTGTA.CACCCAAAG.AACAGAAAC	COPD
copd.o2_TAGCTTGTA.CTAGGTCCT.AAGCCTTCT	COPD
copd.o2_TAGCTTGTA.TTGCGTACA.ACTGAATTC_2	COPD
copd.o2_TAGCTTGTA.TTGGAGGTA.AACATCCAT	COPD
copd.o2_TAGCTTGTA.AAACTGCGC.GTCTTGGCA	COPD
copd.o2_TAGCTTGTA.ATTACCAAG.ACACCTTAG	COPD
copd.o2_TAGCTTGTA.CTTGCTTCA.CATGAATGA	COPD
copd.o2_TAGCTTGTA.CAATTGATC.TCTACGACA	COPD
copd.o2_TAGCTTGTA.TACTAGTCA.CATAACGTT	COPD
copd.o2_ACACGAGAT.CAGAAATCG.ACACCTTAG	COPD
copd.o2_ACACGAGAT.ATCCTAGGA.AAGTTTACG	COPD
copd.o2_ACACGAGAT.CAGTGCCCG.CATAACGTT	COPD
copd.o2_ACACGAGAT.ATTAGGCAT.CTGTACGGA	COPD
copd.o2_ACACGAGAT.AAATAAATA.GATCTCTTA	COPD
copd.o2_ACACGAGAT.CAGCACTTC.AGTTGTTCT	COPD
copd.o2_ACACGAGAT.TACTAGTCA.CAACCTCCA	COPD
copd.o2_ACACGAGAT.CAACAACGG.AATTCGGCG	COPD
copd.o2_AACCGCCTC.TGTGAAGAA.GTAGAAGCA	COPD
copd.o2_AACCGCCTC.CACCCAAAG.AAATGGAGG	COPD
copd.o2_AACCGCCTC.TTCCATTGA.GATCAGCGA	COPD
copd.o2_AACCGCCTC.ATTCATCGT.GGTTGGACA	COPD
copd.o2_AACCGCCTC.AGGAGGCGC.CATAACGTT	COPD
copd.o2_AACCGCCTC.GCCTGTTCA.CTACATGCG	COPD
copd.o2_AACCGCCTC.CACCTACCC.CAAGTTTCC	COPD
copd.o2_AACCGCCTC.ACTATCCTC.ATATTGTAA	COPD
copd.o2_AACCGCCTC.ACTTGATGA.AAGGGTCAG	COPD
copd.o2_AACCGCCTC.CTTGCTTCA.GGCTACAGA	COPD
copd.o2_AACCGCCTC.AACCCTCGG.GCTATGGAA	COPD
copd.o2_AACCGCCTC.AACCAAAGT.AAGGCCGCA	COPD
copd.o2_AACCGCCTC.TACTAGTCA.CAACCTCCA	COPD
copd.o2_ATTTAGATG.TGTTCTCCA.GCTCCTTGA	COPD
copd.o2_ATTTAGATG.CAGAAATCG.AACAGAAAC	COPD
copd.o2_ATTTAGATG.AGTGTTGTC.AAGTTTACG	COPD
copd.o2_ATTTAGATG.ACTGTTAGA.AAAGTCATT_1	COPD
copd.o2_ATTTAGATG.GCCTGTTCA.AGCTATGTG	COPD
copd.o2_ATTTAGATG.AAGAGTAGA.ACGAACCAG	COPD
copd.o2_ATTTAGATG.ATCAACCGA.AAAGAGGCC	COPD
copd.o2_ATTTAGATG.GATGAACTG.AATAAACAA	COPD
copd.o2_ATTTAGATG.AAACTGCGC.AACAGAAAC	COPD
copd.o2_CAAGCAAGC.CACCCAAAG.CAATAGGGT_1	COPD
copd.o2_CAAGCAAGC.CTAGGTCCT.CAAGTAGAA	COPD
copd.o2_CAAGCAAGC.ACCAAAATG.CTATCATGA	COPD
copd.o2_CAAGCAAGC.AGTGTTGTC.TCAGATTCA	COPD
copd.o2_CAAGCAAGC.ACGACCACC.GGTTGGACA	COPD
copd.o2_CAAGCAAGC.AGGAGGCGC.AATGTATCG	COPD
copd.o2_CAAGCAAGC.GTACATCTA.GATGGTCCA	COPD
copd.o2_CAAGCAAGC.CCGTATCTA.TCTCGGTTA	COPD
copd.o2_CAAGCAAGC.AGGATTCAA.CAAACGTGG	COPD
copd.o2_CAAGCAAGC.GCCAATGTA.GTCTTGGCA	COPD
copd.o2_CAAGCAAGC.CAACAACGG.ACTTACGAT_2	COPD
copd.o2_CAAAGTGTG.CTAGGTCCT.ACAGGCTCC	COPD
copd.o2_CAAAGTGTG.AGCGACACC.AACATCCAT	COPD
copd.o2_CAAAGTGTG.AAGCTACTT.ACTAGACCG	COPD
copd.o2_CAAAGTGTG.CAGAAATCG.TCCGTCTTA	COPD
copd.o2_CAAAGTGTG.ACTATCCTC.AAGTTTACG	COPD
copd.o2_CAAAGTGTG.ACCTGAGTC.TACTTCGGA	COPD
copd.o2_CAAAGTGTG.AGATAGTTC.CAACGATCT	COPD
copd.o2_CAAAGTGTG.CAATTGATC.AAAGAGGCC	COPD
copd.o2_CAAAGTGTG.ACAATATGG.AAATGGAGG	COPD
copd.o2_GGCAAGCAA.CACAAAGGC.AACAACGCG	COPD
copd.o2_GGCAAGCAA.CTAGGTCCT.CAATACAAG_2	COPD
copd.o2_GGCAAGCAA.ACGCGAAGC.AAATGGAGG	COPD
copd.o2_GGCAAGCAA.ATCCTAGGA.ACAACTAGT	COPD
copd.o2_GGCAAGCAA.ACTGTTAGA.TGAAGCCAA	COPD
copd.o2_GGCAAGCAA.TGACAGACA.AACGTGTGA	COPD
copd.o2_GGCAAGCAA.TAGAACACA.CAATACAAG_1	COPD
copd.o2_GGCAAGCAA.CCGTATCTA.CATAACGTT	COPD
copd.o2_GGCAAGCAA.AAGGACTAT.TCAGATTCA	COPD
copd.o2_GGCAAGCAA.AGAGGACCA.ATCATTCTG	COPD
copd.o2_GGCAAGCAA.AACCAAAGT.CTGTACGGA	COPD
copd.o2_GGCAAGCAA.GAGTGCGAA.ACGAACCAG	COPD
copd.o2_GAGCCAATA.AAGCTACTT.ATATTGTAA	COPD
copd.o2_GAGCCAATA.ATCCTAGGA.TTAGGCATA	COPD
copd.o2_GAGCCAATA.GACCTTAGA.CAGGGAGGG	COPD
copd.o2_GAGCCAATA.AGGATTCAA.AGCCTGGTT	COPD
copd.o2_GAGCCAATA.ATCAACCGA.AGTCTGTAC	COPD
copd.o2_GAGCCAATA.ATGAGTTAC.TCTCACGGA	COPD
copd.o2_GAGCCAATA.CACTCGAGA.CTGTACGGA	COPD
copd.o2_GAGCCAATA.CTTGCTTCA.AGTAATTAG	COPD
copd.o2_GAGCCAATA.CTTGCTTCA.AAGGGAACT	COPD
copd.o2_GAGCCAATA.ACCAGGTGT.CAATAGGGT	COPD
copd.o2_ATGTAATGG.TACAGGATA.GTAGAAGCA	COPD
copd.o2_ATGTAATGG.AGCGACACC.CTATTAGCC	COPD
copd.o2_ATGTAATGG.AAGCTACTT.AATTCGGCG_1	COPD
copd.o2_ATGTAATGG.AGTGTTGTC.GCAACATTA	COPD
copd.o2_ATGTAATGG.TAGTCTTGA.AAAGAGGCC	COPD
copd.o2_ATGTAATGG.TTGCGTACA.CTGTACGGA	COPD
copd.o2_ATGTAATGG.AGGAGGCGC.GTAGAAGCA	COPD
copd.o2_ATGTAATGG.TCATTGAGA.CAATAGGGT	COPD
copd.o2_ATGTAATGG.GCTAACTCA.ACTTACGAT	COPD
copd.o2_ATGTAATGG.GATGAACTG.AGTCTGTAC	COPD
copd.o2_ATGTAATGG.CGTTCGGTA.CACAAGTAT	COPD
copd.o2_CCTGAGCAA.AGCGACACC.ACTACATAT	COPD
copd.o2_CCTGAGCAA.TAGTCTTGA.TTCAGCTCA	COPD
copd.o2_CCTGAGCAA.AAACTGCGC.ACTAGACCG	COPD
copd.o2_CCTGAGCAA.ACCTGAGTC.TCTACGACA	COPD
copd.o2_GAGTACATT.TGTTCTCCA.TCCGTCTTA	COPD
copd.o2_GAGTACATT.GCCTGTTCA.CTAAGCTTC	COPD
copd.o2_GAGTACATT.AATCAGTTT.TGCATAGTA	COPD
copd.o2_GAGTACATT.CCGACAAGA.CAATAGGGT	COPD
copd.o2_GAGTACATT.AGGATTCAA.ACTCATACG	COPD
copd.o2_GAGTACATT.CTCTCTCAA.AAGCCTTCT	COPD
copd.o2_GAGTACATT.CGTTCGGTA.AAATTACAG	COPD
copd.o2_GAGTACATT.AGATAGTTC.ACTAGACCG	COPD
copd.o2_TGCGATCTA.ACGCGAAGC.CAGCCTGGC	COPD
copd.o2_TGCGATCTA.TTGCGTACA.TCTCGGTTA	COPD
copd.o2_TGCGATCTA.TCATTGAGA.CAGGGAGGG	COPD
copd.o2_TGCGATCTA.ACTTTAACT.ATGGGACTC	COPD
copd.o2_TGCGATCTA.ACTTTAACT.ACAAACTTT	COPD
copd.o2_TGCGATCTA.AGGCAGCTA.CGTACTACG	COPD
copd.o3_GTCGCTATA.ACCAAAATG.ACTCATACG	COPD
copd.o3_GTCGCTATA.ACTTTAACT.ATATTGTAA	COPD
copd.o3_CTTGTACTA.AGGGCTGGT.ACGTGGGAG	COPD
copd.o3_CTTGTACTA.TACTAGTCA.AAATTACAG	COPD
copd.o3_CTTCACATA.ACCAAAATG.GGTGAGTTA	COPD
copd.o3_ACACGCCGG.CACCCAAAG.ACTGAATTC	COPD
copd.o3_ACACGCCGG.CACTCGAGA.AAGCCTTCT	COPD
copd.o3_CGGTCCAGG.TACTAGTCA.CAATAGGGT	COPD
copd.o3_ATTGGCTAA.TCATCCTAA.GTTAGCCTA	COPD
copd.o3_ATTGGCTAA.ACTTCGAGC.CATGAATGA	COPD
copd.o3_ATTGGCTAA.AAACGTACC.AAGGGTCAG	COPD
copd.o3_ATTGGCTAA.ACAATATGG.TCCGTCTTA	COPD
copd.o3_AAGACATGC.ACTGTTAGA.GTAGAAGCA	COPD
copd.o3_AAGACATGC.CGCTAAGCA.ACAAGTGCA	COPD
copd.o3_AAGGCGATC.ACTTCGAGC.TCCGTCTTA	COPD
copd.o3_AAGGCGATC.GTGCAGTAA.GGCTACAGA	COPD
copd.o3_GTGTCCTTA.CCGACAAGA.ACTAGACCG	COPD
copd.o3_GTGTCCTTA.TAGTGACTA.TCTCACGGA	COPD
copd.o3_GGATTAGGA.AACCCTCGG.AAATTACAG	COPD
copd.o3_GGATTAGGA.AGGCAGCTA.CAATAGGGT	COPD
copd.o3_ATGGATCCA.AGATAGTTC.CTCAAGACA	COPD
copd.o3_ACATAAGCG.CACTTATGT.ACAAGTGCA	COPD
copd.o3_AACTGTATT.ATCCAACCG.AATTCGGCG	COPD
copd.o3_ACCTTGCGG.AAATAAATA.AAAGAGGCC	COPD
copd.o3_CAGGTGTAG.GATGAACTG.ATCGAGTCT	COPD
copd.o3_AGGAGATTA.GATTCATCA.GTTAGCCTA	COPD
copd.o3_ACCGGATAG.ATCCTAGGA.AAATGGAGG	COPD
copd.o3_ACCGGATAG.CGCTAAGCA.TTCAGCTCA	COPD
copd.o3_TAAGTTCGA.TACAGGATA.AAATTACAG	COPD
copd.o3_TAAGTTCGA.AGGCAGCTA.GGCTACAGA	COPD
copd.o3_TAAGTTCGA.AACCAAAGT.AGCCTGGTT	COPD
copd.o3_TGGCTCAGA.AGGATTCAA.CAGCCTGGC_2	COPD
copd.o3_TGGCTCAGA.AGGATTCAA.TTCAGCTCA	COPD
copd.o3_TGGCTCAGA.AGTGAAAGG.CAAGTAGAA	COPD
copd.o3_ACCAAGGAC.AATCAGTTT.GTTAGCCTA	COPD
copd.o3_ACCAAGGAC.TAGAACACA.CAGCCTGGC	COPD
copd.o3_ACCAAGGAC.ATTACCAAG.ACGTGGGAG	COPD
copd.o3_AGTATCTGT.CAGAAATCG.TCCTCAATA	COPD
copd.o3_GCACTGTCA.AGGATTCAA.TCTCACGGA	COPD
copd.o3_GCACTGTCA.TTGGAGGTA.AACATCCAT	COPD
copd.o3_ATACTTAGG.ACACATGTC.ATGGTCCGT	COPD
copd.o3_ATACTTAGG.CGTTCGGTA.CAATACAAG	COPD
copd.o3_ATACTTAGG.ACCAGGTGT.GCTATGGAA	COPD
copd.o3_ACGCAATCA.TACAGGATA.ACTACATAT	COPD
copd.o3_GAGTATTAG.CAGAAATCG.GATCTCTTA	COPD
copd.o3_GAGTATTAG.GTGCAGTAA.CGTACTACG	COPD
copd.o3_GACGGATTA.CACCCAAAG.TGAAGCCAA	COPD
copd.o3_GACGGATTA.TGACAGACA.AATTACCGG	COPD
copd.o3_GACGGATTA.TTGGTATGA.AACAGAAAC	COPD
copd.o3_GACGGATTA.GTGCAGTAA.CTATCATGA	COPD
copd.o3_GACGGATTA.CAATTGATC.GAACGACAA	COPD
copd.o3_CAGCTGACA.CCATGCACA.ACTGAATTC	COPD
copd.o3_CAACATATT.AATCAGTTT.CAGGGAGGG	COPD
copd.o3_AACTTCTCC.AAACGTACC.TGCATAGTA	COPD
copd.o3_CTATGAAAT.TCATTGAGA.AGTTGTTCT	COPD
copd.o3_CTATGAAAT.TATAGCCCT.ATCATTCTG	COPD
copd.o3_CTATGAAAT.AGTGAAAGG.GATCTCTTA	COPD
copd.o3_ATTATTACC.CAATTGATC.GCTATGGAA	COPD
copd.o3_TACCGAGCA.ATCCTAGGA.CGTCTAGGT	COPD
copd.o3_TACCGAGCA.ATTACCAAG.GGTTGGACA	COPD
copd.o3_TCTCTTCAA.TAGTGACTA.TACTTCGGA	COPD
copd.o3_GCCTTACAA.CACTCGAGA.CACAAGTAT	COPD
copd.o3_AGCACACAG.GCTAACTCA.GCTATGGAA	COPD
copd.o3_AGCACACAG.ACTTTAACT.AAGCCTTCT	COPD
copd.o3_AGCACACAG.GATGAACTG.GATCTCTTA	COPD
copd.o3_ACAGTTCCG.AAACGTACC.TCCTCAATA	COPD
copd.o3_ACAGTTCCG.TTGGTATGA.GGCTACAGA	COPD
copd.o3_AGTAAAGCC.ACCAAAATG.AGTCTGTAC	COPD
copd.o3_CGTTACTAA.ATCAACCGA.GATCTCTTA	COPD
copd.o3_TTGTTCCAA.ACTTCGAGC.AAATTACAG	COPD
copd.o3_TTGTTCCAA.CAGTGCCCG.CAGCCTGGC	COPD
copd.o3_TTGTTCCAA.ACAATATGG.AAATGGAGG	COPD
copd.o3_AGAAGCACT.GTGCAGTAA.ACGAACCAG	COPD
copd.o3_AGAAGCACT.AAGGACTAT.ACACCTTAG_2	COPD
copd.o3_CAGCAAGAT.CTAGGTCCT.AAATGGAGG	COPD
copd.o3_CAGCAAGAT.TCGTTAGCA.CAATACAAG	COPD
copd.o3_CAAACCGCC.TGTTCTCCA.GCTATGGAA	COPD
copd.o3_AATATTGGG.AAACGTACC.TGTCTATCA	COPD
copd.o3_AATATTGGG.ACCAGGTGT.AACAGAAAC	COPD
copd.o3_AAGCTCAAC.TAGTCTTGA.AAGTTTACG	COPD
copd.o3_AAGCTCAAC.AAACGTACC.AGTTGCATC	COPD
copd.o3_AAGCTCAAC.AGCTGCCGT.TCTCGGTTA	COPD
copd.o3_TCCAGTCGA.TGTTCTCCA.GCTATGGAA	COPD
copd.o3_TCCAGTCGA.CACCTACCC.CGTCTAGGT_2	COPD
copd.o3_AACGAGAAG.TCGTTAGCA.GCAACATTA	COPD
copd.o3_CTACAGAAC.CGTTCGGTA.AACGTGTGA	COPD
copd.o3_TCAGGAGGA.ACCTGAGTC.CGTCTAGGT	COPD
copd.o3_ACCCTGACC.CACTCGAGA.ACTACATAT	COPD
copd.o3_ACAAGGATC.GTGTGTCGA.ATGGGACTC	COPD
copd.o3_ATCCCGGAG.TGACAGACA.GTCTTGGCA	COPD
copd.o3_ATCCCGGAG.GCCAATGTA.AAAGTCATT	COPD
copd.o3_ATCCCGGAG.CACTTATGT.GATCAGCGA	COPD
copd.o3_ATCCCGGAG.AACCCTCGG.ATCATTCTG	COPD
copd.o3_TCGAAGTGA.ACTGTTAGA.TCCTCAATA	COPD
copd.o3_CAGAATCGT.GGAGTCTAA.CAGGGAGGG	COPD
copd.o3_CAGAATCGT.AGGATTCAA.CAAGTTTCC	COPD
copd.o3_CAGAATCGT.CGCTAAGCA.TGCATAGTA	COPD
copd.o3_ATCTCCACA.TTGGAGGTA.ATGGTCCGT	COPD
copd.o3_ATCTCCACA.ATCCAACCG.AAATTACAG	COPD
copd.o3_ACGAAAGGT.ATTACCAAG.AAGTTTACG	COPD
copd.o3_TAGCTTGTA.TAGAACACA.CAAGTAGAA	COPD
copd.o3_ACACGAGAT.AGCTGCCGT.CAAACGTGG	COPD
copd.o3_AACCGCCTC.ACGATGAAT.TCTCACGGA	COPD
copd.o3_AACCGCCTC.CTCTCTCAA.AACAGAAAC	COPD
copd.o3_AACCGCCTC.CACTTATGT.CTATTAGCC	COPD
copd.o3_ATTTAGATG.GATTCATCA.AACAACGCG	COPD
copd.o3_GGCAAGCAA.GTGTGTCGA.GCTCCTTGA	COPD
copd.o3_GGCAAGCAA.CAACAACGG.CAATACAAG	COPD
copd.o3_GAGCCAATA.TAGAACACA.ACACCTTAG	COPD
copd.o3_ATGTAATGG.GCTAACTCA.AACAACGCG	COPD
copd.o3_CCTGAGCAA.AGTGTTGTC.GGCACAACA	COPD
copd.o3_CCTGAGCAA.TTGCGTACA.ATATTGTAA	COPD
copd.o3_CCTGAGCAA.AACCCTCGG.GATGGTCCA_1	COPD
copd.o3_GAGTACATT.CAGCACTTC.ACAAACTTT	COPD
ctl.y2_GTCGCTATA.ACAGTGGTA.CAGGGAGGG	healthy
ctl.y2_GTCGCTATA.ACAGTGGTA.TCCGTCTTA	healthy
ctl.y2_GTCGCTATA.TTGGTATGA.TCCGTCTTA	healthy
ctl.y2_GTCGCTATA.AACTCATTG.CTACATGCG	healthy
ctl.y2_CTTGTACTA.ACAGTGGTA.AGTTGCATC	healthy
ctl.y2_CTTGTACTA.AGTGTTGTC.AAGTTTACG	healthy
ctl.y2_CTTGTACTA.GACACTTAA.ACTCATACG	healthy
ctl.y2_CTTGTACTA.AAACGTACC.ACAAGTGCA	healthy
ctl.y2_CTTGTACTA.ACACATGTC.CACGATCCG	healthy
ctl.y2_CTTGTACTA.AGGTTCGCT.CAATACAAG	healthy
ctl.y2_ACACGCCGG.ACAGTGGTA.CTGTACGGA	healthy
ctl.y2_ACACGCCGG.CAAGACCTA.AACAGAAAC	healthy
ctl.y2_ACACGCCGG.GCCAATGTA.CGTACTACG	healthy
ctl.y2_ACACGCCGG.CCATGCACA.CAAGTAGAA	healthy
ctl.y2_ACACGCCGG.CAATTGATC.CATGAATGA	healthy
ctl.y2_CGGTCCAGG.CAGAAATCG.AAGCCTTCT	healthy
ctl.y2_CGGTCCAGG.AAGGACTAT.ACTTACGAT	healthy
ctl.y2_AATCGAATG.TACAGGATA.CATGAATGA	healthy
ctl.y2_AATCGAATG.ACCAAAATG.ACAACTAGT	healthy
ctl.y2_AATCGAATG.ATGAGTTAC.AAATGGAGG	healthy
ctl.y2_CCTAGTATA.TACAGGATA.CAATACAAG	healthy
ctl.y2_CCTAGTATA.GTGCAGTAA.GATCAGCGA	healthy
ctl.y2_CCTAGTATA.AGGATTCAA.AATTACCGG	healthy
ctl.y2_CCTAGTATA.ACCAGGTGT.TCCGTCTTA	healthy
ctl.y2_ATTGGCTAA.ACTTCGAGC.ATCATTCTG	healthy
ctl.y2_ATTGGCTAA.GACACTTAA.ACAAGTGCA	healthy
ctl.y2_ATTGGCTAA.AAGAGTAGA.CAAGTAGAA	healthy
ctl.y2_ATTGGCTAA.ACCAGGTGT.CACGATCCG	healthy
ctl.y2_AAGACATGC.CACCTACCC.GATGGTCCA	healthy
ctl.y2_AAGACATGC.GCTAACTCA.TCTACGACA	healthy
ctl.y2_AAGACATGC.AAGGACTAT.CAGCCTGGC	healthy
ctl.y2_AAGGCGATC.ATCCTAGGA.ACAAGTGCA	healthy
ctl.y2_AAGGCGATC.TTCCATTGA.AAAGTCATT	healthy
ctl.y2_AAGGCGATC.ATTACCAAG.CAGGGAGGG	healthy
ctl.y2_GTGTCCTTA.AAGCTACTT.GGCTACAGA	healthy
ctl.y2_GTGTCCTTA.TAGAACACA.CTAAGCTTC	healthy
ctl.y2_GTGTCCTTA.AGAGGACCA.TCTACGACA	healthy
ctl.y2_GGATTAGGA.ATTCATCGT.ATGGTCCGT	healthy
ctl.y2_GGATTAGGA.CCATGCACA.GATCAGCGA	healthy
ctl.y2_GGATTAGGA.AGAGGACCA.GTCTTGGCA	healthy
ctl.y2_GGATTAGGA.TACTAGTCA.ACACCTTAG	healthy
ctl.y2_ATGGATCCA.CACAAAGGC.AACGTGTGA	healthy
ctl.y2_ATGGATCCA.AGTGTTGTC.GGCACAACA	healthy
ctl.y2_ATGGATCCA.AGTGTTGTC.AAGTTTACG	healthy
ctl.y2_ATGGATCCA.AATCCTGAA.TCCGTCTTA	healthy
ctl.y2_ATGGATCCA.GCTAACTCA.CAACCTCCA	healthy
ctl.y2_ATGGATCCA.TTGGAGGTA.CAACCTCCA	healthy
ctl.y2_ATGGATCCA.ATCCAACCG.AAGTTTACG	healthy
ctl.y2_ATGGATCCA.AAGGACTAT.AAAGAGGCC	healthy
ctl.y2_ACATAAGCG.AAATAAATA.AATGTATCG	healthy
ctl.y2_ACATAAGCG.CAGCACTTC.CTATTAGCC	healthy
ctl.y2_AACTGTATT.CAGTGCCCG.ACGCTGTTG	healthy
ctl.y2_AACTGTATT.GATGAACTG.AATGTATCG	healthy
ctl.y2_AACTGTATT.TAGTGACTA.AATAAACAA	healthy
ctl.y2_AACTGTATT.AGGCAGCTA.AATTCGGCG	healthy
ctl.y2_AACTGTATT.GAGTGCGAA.TGCATAGTA	healthy
ctl.y2_ACCTTGCGG.CACCCAAAG.AGCCTGGTT	healthy
ctl.y2_ACCTTGCGG.AAATAAATA.AAGGGTCAG	healthy
ctl.y2_ACCTTGCGG.GGAATGATA.CTCAAGACA	healthy
ctl.y2_ACCTTGCGG.GCCAATGTA.CATGAATGA	healthy
ctl.y2_ACCTTGCGG.ACCAGGTGT.GGCTACAGA	healthy
ctl.y2_ACCTTGCGG.AGGCAGCTA.ACATTCGGC	healthy
ctl.y2_ACCTTGCGG.AATTATAAC.AAGGGTCAG	healthy
ctl.y2_CAGGTGTAG.AAGAGTAGA.GGTTGGACA	healthy
ctl.y2_AGGAGATTA.ACGACCACC.TCAGATTCA	healthy
ctl.y2_AGGAGATTA.GACACTTAA.GCAACATTA	healthy
ctl.y2_AGGAGATTA.AGAATGGAG.CACAAGTAT	healthy
ctl.y2_GCGATTACA.AGTGTTGTC.TTAGGCATA	healthy
ctl.y2_GCGATTACA.AGTGTTGTC.ACTCATACG	healthy
ctl.y2_GCGATTACA.TTGCGTACA.CAAGTTTCC	healthy
ctl.y2_GCGATTACA.AGGAGGCGC.AAGCCTTCT	healthy
ctl.y2_GCGATTACA.GCTAACTCA.AGCCTGGTT	healthy
ctl.y2_GCGATTACA.AACTCATTG.GATCAGCGA	healthy
ctl.y2_ACCGGATAG.TGTTCTCCA.ATGGTCCGT	healthy
ctl.y2_ACCGGATAG.TAGTCTTGA.AACGTGTGA	healthy
ctl.y2_ACCGGATAG.TGACAGACA.AGTAATTAG	healthy
ctl.y2_ACCGGATAG.ATGAGTTAC.ACTCATACG	healthy
ctl.y2_CCACTTGGA.AAACGTACC.ACTAGACCG	healthy
ctl.y2_CCACTTGGA.TTGGTATGA.CAACGATCT	healthy
ctl.y2_CCACTTGGA.CAACAACGG.GCTATGGAA	healthy
ctl.y2_AGAGAAGTT.AATCAGTTT.AGCCGCAAG	healthy
ctl.y2_AGAGAAGTT.ACTATCCTC.AAGTTTACG	healthy
ctl.y2_AGAGAAGTT.AAACTGCGC.ACTACATAT	healthy
ctl.y2_TAAGTTCGA.TACAGGATA.TGTCTATCA	healthy
ctl.y2_TAAGTTCGA.AGGGCTGGT.TGAAGCCAA_1	healthy
ctl.y2_TAAGTTCGA.CAGTGCCCG.ACTAGACCG_2	healthy
ctl.y2_TAAGTTCGA.AATCAGTTT.CGTACTACG	healthy
ctl.y2_TAAGTTCGA.CCGTATCTA.ACACCTTAG	healthy
ctl.y2_TAAGTTCGA.CTCTCTCAA.ACGCTGTTG	healthy
ctl.y2_TAAGTTCGA.ATGAGTTAC.GGTGAGTTA	healthy
ctl.y2_ACGGATATT.AAGCTACTT.CTATCATGA	healthy
ctl.y2_TGGCTCAGA.CAAGACCTA.TCCTCAATA	healthy
ctl.y2_TGGCTCAGA.GATGAACTG.AGTTGTTCT	healthy
ctl.y2_TGGCTCAGA.CAATTGATC.ACGTGGGAG	healthy
ctl.y2_ACCAAGGAC.AGGGCTGGT.AACGTGTGA	healthy
ctl.y2_ACCAAGGAC.ACTGTTAGA.CGTCTAGGT	healthy
ctl.y2_ACCAAGGAC.GACCTTAGA.ACTCATACG	healthy
ctl.y2_ACCAAGGAC.AGAGGACCA.ACAGGCTCC	healthy
ctl.y2_AGTATCTGT.AGGGCTGGT.GATCTCTTA	healthy
ctl.y2_AGTATCTGT.ATTCATCGT.CTCAAGACA	healthy
ctl.y2_AGTATCTGT.CTTGCTTCA.AACGTGTGA	healthy
ctl.y2_AGTATCTGT.AATTATAAC.CAAGTAGAA	healthy
ctl.y2_CACACACTA.CCGACAAGA.CAATACAAG	healthy
ctl.y2_CACACACTA.GTGCAGTAA.CAGGGAGGG	healthy
ctl.y2_CACACACTA.AGGATTCAA.CAAACGTGG	healthy
ctl.y2_CACACACTA.TTGGAGGTA.GATGGTCCA	healthy
ctl.y2_CACACACTA.AGGTTCGCT.TGAAGCCAA	healthy
ctl.y2_ATTAAGTGC.ATGAGTTAC.TGAAGCCAA_2	healthy
ctl.y2_AAGTAACCC.CTAGGTCCT.CACAAGTAT	healthy
ctl.y2_AAATCCTGT.GTGTGTCGA.ATCATTCTG	healthy
ctl.y2_AAATCCTGT.CAGTGCCCG.CAGCCTGGC	healthy
ctl.y2_AAATCCTGT.AAACTGCGC.CTAGATAGA	healthy
ctl.y2_CACATTGCA.CAGAAATCG.AGCTATGTG	healthy
ctl.y2_CACATTGCA.CACCTACCC.ACTAGACCG	healthy
ctl.y2_CACATTGCA.GCATGGCTA.AGTTGCATC	healthy
ctl.y2_GCACTGTCA.ACCAAAATG.ACTACATAT	healthy
ctl.y2_GCACTGTCA.ATCCTAGGA.GCTATGGAA	healthy
ctl.y2_GCACTGTCA.ACCTGAGTC.CGTCTAGGT	healthy
ctl.y2_GCACTGTCA.AACCAAAGT.GCTATGGAA	healthy
ctl.y2_ATACTTAGG.CTCTCTCAA.AAAGAGGCC	healthy
ctl.y2_ATACTTAGG.ACTTTAACT.TGTATGCGA	healthy
ctl.y2_ATACTTAGG.AAGGACTAT.ACAAACTTT	healthy
ctl.y2_ATACTTAGG.ACCAGGTGT.CAAGTTTCC_2	healthy
ctl.y2_GCAATCCGA.CACCAGGTA.ACTCCAGGG	healthy
ctl.y2_ACGCAATCA.ATTAGGCAT.AAGTTTACG_2	healthy
ctl.y2_ACGCAATCA.AACCCTCGG.ACAAGTGCA	healthy
ctl.y2_GAGTATTAG.AAGCTACTT.GGCTACAGA	healthy
ctl.y2_GAGTATTAG.CCGTATCTA.AAGGGTCAG	healthy
ctl.y2_GAGTATTAG.AGGTTCGCT.GGCTACAGA	healthy
ctl.y2_GAGTATTAG.AACCCTCGG.ACAAACTTT	healthy
ctl.y2_GACGGATTA.ACCAAAATG.GAACGACAA	healthy
ctl.y2_GACGGATTA.TCATCCTAA.ATCATTCTG	healthy
ctl.y2_GACGGATTA.AAATAAATA.CAAGTTTCC	healthy
ctl.y2_GACGGATTA.CAATTGATC.TCTCGGTTA	healthy
ctl.y2_CAGCTGACA.GATTCATCA.ACTCATACG	healthy
ctl.y2_CAGCTGACA.CAGAAATCG.ACGCTGTTG	healthy
ctl.y2_CAGCTGACA.GGAATGATA.CAACGATCT	healthy
ctl.y2_CAGCTGACA.TAGTGACTA.GATGGTCCA	healthy
ctl.y2_CAGCTGACA.AACCAAAGT.ACACCTTAG	healthy
ctl.y2_CAACATATT.ACCAAAATG.ACAAGTGCA	healthy
ctl.y2_CAACATATT.AAATAAATA.ACAAGTGCA	healthy
ctl.y2_CAACATATT.ATCAACCGA.CTACATGCG	healthy
ctl.y2_CAACATATT.ATGAGTTAC.ACATTCGGC	healthy
ctl.y2_CAACATATT.TAGTGACTA.AACGTGTGA	healthy
ctl.y2_CAACATATT.GCATGGCTA.GATCTCTTA_2	healthy
ctl.y2_AACTTCTCC.TAGGGATAC.ATCATTCTG	healthy
ctl.y2_AACTTCTCC.AGTGAAAGG.ACGCTGTTG	healthy
ctl.y2_CTATGAAAT.TCATCCTAA.ACTCATACG	healthy
ctl.y2_CTATGAAAT.AGGAGGCGC.TACTTCGGA	healthy
ctl.y2_ATTATTACC.TCATCCTAA.GATCTCTTA	healthy
ctl.y2_ATTATTACC.GCCTGTTCA.AAGTTTACG	healthy
ctl.y2_ATTATTACC.AATCAGTTT.CACAAGTAT	healthy
ctl.y2_ATTATTACC.AGAATGGAG.AACAACGCG	healthy
ctl.y2_TACCGAGCA.ATTAGGCAT.GCAACATTA	healthy
ctl.y2_TACCGAGCA.CAAGACCTA.GTCTTGGCA	healthy
ctl.y2_TACCGAGCA.ATTACCAAG.ACATTCGGC	healthy
ctl.y2_TACCGAGCA.CACTCGAGA.CAATACAAG	healthy
ctl.y2_TCTCTTCAA.AGGGCTGGT.AAGGGAACT	healthy
ctl.y2_TCTCTTCAA.AGAATGGAG.AGTCTGTAC	healthy
ctl.y2_TCTCTTCAA.ATCAACCGA.TCTCGGTTA	healthy
ctl.y2_TAAGCGTTA.TGTGAAGAA.ACGCTGTTG	healthy
ctl.y2_TAAGCGTTA.TGACAGACA.CAGCCTGGC	healthy
ctl.y2_TAAGCGTTA.ACAATATGG.AGCCGCAAG	healthy
ctl.y2_TAAGCGTTA.CAGCACTTC.ATCATTCTG	healthy
ctl.y2_TAAGCGTTA.AACCCTCGG.AATAAACAA	healthy
ctl.y2_GCCTTACAA.TCGTTAGCA.AAGGGAACT	healthy
ctl.y2_GCCTTACAA.ATTCATCGT.GGTGAGTTA	healthy
ctl.y2_GCCTTACAA.ACTTCGAGC.CTATCATGA	healthy
ctl.y2_AGCACACAG.TAGGGATAC.CATAACGTT	healthy
ctl.y2_AGCACACAG.AGAATGGAG.TCTCACGGA	healthy
ctl.y2_ACAGTTCCG.AGCGACACC.GATGGTCCA	healthy
ctl.y2_ACAGTTCCG.TCATCCTAA.AGTTGCATC	healthy
ctl.y2_ACAGTTCCG.TTGCGTACA.GATCTCTTA	healthy
ctl.y2_ACAGTTCCG.AAATAAATA.AATAAACAA	healthy
ctl.y2_ACAGTTCCG.GTGCAGTAA.CAATACAAG	healthy
ctl.y2_ACAGTTCCG.ACTTTAACT.ACGCTGTTG	healthy
ctl.y2_ACAGTTCCG.ACTTTAACT.CAATAGGGT	healthy
ctl.y2_ACAGTTCCG.CTTGCTTCA.ACTTACGAT	healthy
ctl.y2_ACAGTTCCG.AGGCAGCTA.CTATTAGCC	healthy
ctl.y2_ACAGTTCCG.TACTAGTCA.AGTCTGTAC	healthy
ctl.y2_ACAGTTCCG.TACTAGTCA.AATTCGGCG	healthy
ctl.y2_AGTAAAGCC.ACTATCCTC.TGCATAGTA	healthy
ctl.y2_CAGTTTCAC.TCGTTAGCA.AGCTATGTG	healthy
ctl.y2_CAGTTTCAC.AGGGCTGGT.ACTTACGAT	healthy
ctl.y2_CAGTTTCAC.TCATCCTAA.CTACATGCG	healthy
ctl.y2_CAGTTTCAC.CACTCGAGA.AATGTATCG	healthy
ctl.y2_CAGTTTCAC.AGAGGACCA.GATGGTCCA	healthy
ctl.y2_CAGTTTCAC.AGGCAGCTA.GCAACATTA	healthy
ctl.y2_CGTTACTAA.ACTGTTAGA.CGTCTAGGT	healthy
ctl.y2_CGTTACTAA.ACCTGAGTC.TGCATAGTA	healthy
ctl.y2_CGTTACTAA.AATTATAAC.AAGGCCGCA	healthy
ctl.y2_TTGTTCCAA.AGTGAAAGG.AAAGAGGCC	healthy
ctl.y2_AGAAGCACT.TAGTGACTA.AAGGGTCAG	healthy
ctl.y2_AGAAGCACT.ACCTGAGTC.CATAACGTT	healthy
ctl.y2_CAGCAAGAT.GACCTTAGA.GTTAGCCTA	healthy
ctl.y2_CAAACCGCC.AAACTGCGC.CTATCATGA	healthy
ctl.y2_CAAACCGCC.ACCAGGTGT.TTAGGCATA	healthy
ctl.y2_CTAACTCGC.GATTCATCA.CTATTAGCC	healthy
ctl.y2_CTAACTCGC.CACAAAGGC.CAAACGTGG	healthy
ctl.y2_CTAACTCGC.CAGAAATCG.ACTCCAGGG	healthy
ctl.y2_CTAACTCGC.AATCCTGAA.CAAGTTTCC	healthy
ctl.y2_CTAACTCGC.GGAGTCTAA.AATAAACAA	healthy
ctl.y2_CTAACTCGC.ATGAGTTAC.ACTCATACG	healthy
ctl.y2_AATATTGGG.TCATCCTAA.GGCTACAGA_2	healthy
ctl.y2_AATATTGGG.CCGACAAGA.CAACCTCCA_2	healthy
ctl.y2_AGAACTTCC.AAGAGTAGA.AGCTATGTG	healthy
ctl.y2_AGAACTTCC.TCATTGAGA.CTGTACGGA	healthy
ctl.y2_AGAACTTCC.AAACGTACC.AAATTACAG	healthy
ctl.y2_AGAACTTCC.CACTCGAGA.GCTATGGAA	healthy
ctl.y2_CAAAGGCAC.ATCCTAGGA.TCAGATTCA	healthy
ctl.y2_CAAAGGCAC.AGGATTCAA.CGTCTAGGT	healthy
ctl.y2_CAAAGGCAC.ATGAGTTAC.AGCCGCAAG	healthy
ctl.y2_CAAAGGCAC.GATGAACTG.ATCATTCTG	healthy
ctl.y2_AAGCTCAAC.ACACATGTC.AAAGTCATT	healthy
ctl.y2_AAGCTCAAC.ACTTGATGA.CTAGATAGA	healthy
ctl.y2_AAGCTCAAC.ACTTTAACT.GTAGAAGCA	healthy
ctl.y2_AAGCTCAAC.AGTGAAAGG.GGTTGGACA	healthy
ctl.y2_AGCCATCAC.AGCGACACC.TCCGTCTTA	healthy
ctl.y2_AGCCATCAC.TTGGTATGA.AATTCGGCG	healthy
ctl.y2_AGCCATCAC.ATCCAACCG.ATGGGACTC	healthy
ctl.y2_AGCCATCAC.ATCCAACCG.CAATACAAG	healthy
ctl.y2_CTACAGAAC.TTGGTATGA.ACTCATACG	healthy
ctl.y2_CTACAGAAC.GCTAACTCA.GTTAGCCTA_2	healthy
ctl.y2_CTACAGAAC.CGTTCGGTA.GGCACAACA	healthy
ctl.y2_CTACAGAAC.CACTTATGT.ATGGTCCGT	healthy
ctl.y2_CTACAGAAC.GAGTGCGAA.CATGAATGA	healthy
ctl.y2_CTACAGAAC.CGCTAAGCA.CAGGCATTT	healthy
ctl.y2_AGAGCTATG.TCGTTAGCA.GCTCCTTGA	healthy
ctl.y2_AGAGCTATG.CAGAAATCG.ACTGAATTC	healthy
ctl.y2_AGAGCTATG.AGTGTTGTC.CTAGATAGA	healthy
ctl.y2_AGAGCTATG.ATCCTAGGA.GCAACATTA	healthy
ctl.y2_AGAGCTATG.CTTGCTTCA.CTGTACGGA	healthy
ctl.y2_GAGGATGGA.ACGCGAAGC.CATGAATGA	healthy
ctl.y2_GAGGATGGA.TAGTCTTGA.GATCAGCGA	healthy
ctl.y2_GAGGATGGA.TAGTCTTGA.TACTTCGGA	healthy
ctl.y2_GAGGATGGA.AGGATTCAA.AAATGGAGG	healthy
ctl.y2_GAGGATGGA.AGAATGGAG.CTCAAGACA	healthy
ctl.y2_GAGGATGGA.AGTGAAAGG.GCTCCTTGA	healthy
ctl.y2_TGTACCTTA.ACTTCGAGC.ACTCATACG_3	healthy
ctl.y2_TGTACCTTA.AAACTGCGC.CTACATGCG_2	healthy
ctl.y2_TGTACCTTA.AACTCATTG.AAAGTCATT	healthy
ctl.y2_TGTACCTTA.CAATTGATC.AAATGGAGG	healthy
ctl.y2_TCAGGAGGA.GATTCATCA.ACACCTTAG	healthy
ctl.y2_TCAGGAGGA.AGCGACACC.TCTCGGTTA	healthy
ctl.y2_TCAGGAGGA.AGGGCTGGT.ACAGGCTCC	healthy
ctl.y2_TCAGGAGGA.ACGATGAAT.ACTCCAGGG	healthy
ctl.y2_TCAGGAGGA.AACTCATTG.CAATACAAG	healthy
ctl.y2_TCAGGAGGA.AAGGACTAT.AGTAATTAG	healthy
ctl.y2_GAGGTGCTA.GGAATGATA.ACGAACCAG_2	healthy
ctl.y2_GAGGTGCTA.TAGTGACTA.AGTAATTAG	healthy
ctl.y2_ACCCTGACC.CTAGGTCCT.CAGCCTGGC	healthy
ctl.y2_ACCCTGACC.AAGAGTAGA.CTATTAGCC	healthy
ctl.y2_ACCCTGACC.GCCAATGTA.AAGCCTTCT_2	healthy
ctl.y2_ACCCTGACC.CACTCGAGA.CTGTACGGA	healthy
ctl.y2_ACAAGGATC.CAGAAATCG.GCTATGGAA	healthy
ctl.y2_ACAAGGATC.ATCCTAGGA.CTGTACGGA	healthy
ctl.y2_ACAAGGATC.GCCTGTTCA.CTAAGCTTC	healthy
ctl.y2_ATCCCGGAG.CTAGGTCCT.ATGGGACTC	healthy
ctl.y2_ATCCCGGAG.AGTGTTGTC.CAATAGGGT	healthy
ctl.y2_ATCCCGGAG.AATCAGTTT.TACTTCGGA	healthy
ctl.y2_ATCCCGGAG.AAGAGTAGA.GCTCCTTGA	healthy
ctl.y2_ATCCCGGAG.ATTACCAAG.CAACCTCCA	healthy
ctl.y2_ATCCCGGAG.GAGTGCGAA.AGCTATGTG	healthy
ctl.y2_TATGTGGCA.GATGAACTG.ACGTGGGAG	healthy
ctl.y2_GCTGCCAAT.TGTGAAGAA.ACAAGTGCA	healthy
ctl.y2_GCTGCCAAT.CTAGGTCCT.AAGGGTCAG	healthy
ctl.y2_GCTGCCAAT.ACGCGAAGC.GGTTGGACA	healthy
ctl.y2_GCTGCCAAT.ATCCTAGGA.CTACATGCG_3	healthy
ctl.y2_GCTGCCAAT.GCCTGTTCA.GCTCCTTGA	healthy
ctl.y2_ATCAGAGCT.TCATCCTAA.TCCTCAATA	healthy
ctl.y2_ATCAGAGCT.AAACGTACC.AATAAACAA	healthy
ctl.y2_ATCAGAGCT.ACCAGGTGT.CATAACGTT_1	healthy
ctl.y2_ATCAGAGCT.AGTGAAAGG.ACAAACTTT	healthy
ctl.y2_TCGAAGTGA.TGTGAAGAA.TTAGGCATA	healthy
ctl.y2_TCGAAGTGA.TTGGTATGA.ACTTACGAT	healthy
ctl.y2_TCGAAGTGA.AACTCATTG.ACAGTAAAC	healthy
ctl.y2_ATAGACGAG.TGTTCTCCA.AAGCCTTCT	healthy
ctl.y2_ATAGACGAG.TAGTCTTGA.TGTATGCGA	healthy
ctl.y2_ATAGACGAG.TATAGCCCT.CTATCATGA	healthy
ctl.y2_ATAGACGAG.ACAATATGG.ACTAGACCG_2	healthy
ctl.y2_AGCCCAATC.GCCTGTTCA.TCCGTCTTA_2	healthy
ctl.y2_AGCCCAATC.AAATAAATA.GGCTACAGA	healthy
ctl.y2_AGCCCAATC.CAAGACCTA.ACAAGTGCA	healthy
ctl.y2_AGCCCAATC.GCCAATGTA.ACTTACGAT	healthy
ctl.y2_AGCCCAATC.CACTCGAGA.GTTAGCCTA	healthy
ctl.y2_CAGAATCGT.AGCGACACC.ACAGGCTCC	healthy
ctl.y2_CAGAATCGT.TAGGGATAC.CATAACGTT	healthy
ctl.y2_CAGAATCGT.GGAGTCTAA.ACGAACCAG	healthy
ctl.y2_ATCTCCACA.TACAGGATA.AGTTGCATC	healthy
ctl.y2_ATCTCCACA.CACCAGGTA.AAGTTTACG	healthy
ctl.y2_ATCTCCACA.ACCAAAATG.ACTAGACCG	healthy
ctl.y2_ATCTCCACA.AATCCTGAA.CATAACGTT	healthy
ctl.y2_ATCTCCACA.ACGATGAAT.TGAAGCCAA	healthy
ctl.y2_ATCTCCACA.AAATAAATA.GGCTACAGA_2	healthy
ctl.y2_ATCTCCACA.AGGATTCAA.TCCGTCTTA_2	healthy
ctl.y2_ATCTCCACA.CGTTCGGTA.CATAACGTT	healthy
ctl.y2_ACGAAAGGT.TAGAACACA.ACAGTAAAC	healthy
ctl.y2_ACGAAAGGT.ATGAGTTAC.AGCCGCAAG	healthy
ctl.y2_ACGAAAGGT.AAGGACTAT.ATGGTCCGT	healthy
ctl.y2_ACGAAAGGT.GCATGGCTA.AATAAACAA	healthy
ctl.y2_TAGCTTGTA.TAGAACACA.GATAGAGGA	healthy
ctl.y2_ACACGAGAT.CAGAAATCG.CGTCTAGGT	healthy
ctl.y2_ACACGAGAT.TCATCCTAA.GGCACAACA	healthy
ctl.y2_ACACGAGAT.ACTGTTAGA.CTATTAGCC	healthy
ctl.y2_ACACGAGAT.AGGATTCAA.TTAGGCATA	healthy
ctl.y2_ACACGAGAT.ATTACCAAG.AAGGGAACT	healthy
ctl.y2_ATTTAGATG.ACTTCGAGC.ACTCATACG	healthy
ctl.y2_ATTTAGATG.GCATGGCTA.CATGAATGA	healthy
ctl.y2_ATTTAGATG.AGGCAGCTA.GAACGACAA	healthy
ctl.y2_CAAGCAAGC.GCCTGTTCA.TCCTCAATA	healthy
ctl.y2_CAAGCAAGC.AACTCATTG.CGTCTAGGT	healthy
ctl.y2_CAAAGTGTG.TTGGTATGA.TGTATGCGA	healthy
ctl.y2_CAAAGTGTG.GTGCAGTAA.CACGATCCG	healthy
ctl.y2_GGCAAGCAA.ATTAGGCAT.AGTAATTAG	healthy
ctl.y2_GGCAAGCAA.TCATTGAGA.AGTAATTAG	healthy
ctl.y2_GGCAAGCAA.CTTGCTTCA.AATAAACAA	healthy
ctl.y2_GAGCCAATA.ACTTCGAGC.GAACGACAA	healthy
ctl.y2_GAGCCAATA.ACTTCGAGC.AGTTGCATC	healthy
ctl.y2_ATGTAATGG.ATTCATCGT.GCAACATTA	healthy
ctl.y2_ATGTAATGG.GACACTTAA.ATCATTCTG	healthy
ctl.y2_ATGTAATGG.CCGTATCTA.ACGTGGGAG	healthy
ctl.y2_ATGTAATGG.ACTTGATGA.CTACATGCG	healthy
ctl.y2_ATGTAATGG.AGGCAGCTA.GTAGAAGCA	healthy
ctl.y2_ATGTAATGG.AACCAAAGT.GTCTTGGCA	healthy
ctl.y2_CCTGAGCAA.CAGAAATCG.CACAAGTAT	healthy
ctl.y2_CCTGAGCAA.AATCAGTTT.AATGTATCG	healthy
ctl.y2_CCTGAGCAA.AAGAGTAGA.ACTCCAGGG	healthy
ctl.y2_CCTGAGCAA.GCTAACTCA.AACAGAAAC	healthy
ctl.y2_CCTGAGCAA.AAGGACTAT.CATGAATGA	healthy
ctl.y2_TGCGATCTA.AGTGTTGTC.CACGATCCG	healthy
ctl.y2_TGCGATCTA.AATCCTGAA.GATCTCTTA	healthy
ctl.y2_TGCGATCTA.AGGAGGCGC.GTAGAAGCA	healthy
ctl.y2_TGCGATCTA.CCGACAAGA.AATTCGGCG	healthy
ctl.y2_TGCGATCTA.GACCTTAGA.GCAACATTA	healthy
ctl.y2_TGCGATCTA.ACACATGTC.GTAGAAGCA	healthy
ctl.y2_TGCGATCTA.CGTTCGGTA.CTGTACGGA	healthy
ctl.y3_CTTGTACTA.CTCTCTCAA.CATGAATGA	healthy
ctl.y3_ACACGCCGG.TTGCGTACA.AAGGGAACT	healthy
ctl.y3_AATCGAATG.ACGCGAAGC.CAATACAAG	healthy
ctl.y3_GTGTCCTTA.TAGTGACTA.GATAGAGGA	healthy
ctl.y3_ATGGATCCA.CAAGACCTA.GTTAGCCTA	healthy
ctl.y3_ATGGATCCA.ACAATATGG.TACTTCGGA	healthy
ctl.y3_AGGAGATTA.CAACAACGG.ACACCTTAG	healthy
ctl.y3_GCGATTACA.AGATAGTTC.ACAGGCTCC	healthy
ctl.y3_GAATCTGTA.ACGCGAAGC.CTATCATGA	healthy
ctl.y3_ATTAAGTGC.GATTCATCA.ATATTGTAA	healthy
ctl.y3_ATACTTAGG.ATCCAACCG.ATATTGTAA	healthy
ctl.y3_GCAATCCGA.CGTTCGGTA.GGCACAACA	healthy
ctl.y3_GCCTTACAA.TCATCCTAA.GCTATGGAA	healthy
ctl.y3_GCCTTACAA.CCATGCACA.ATCATTCTG	healthy
ctl.y3_AGTAAAGCC.GACACTTAA.AGTAATTAG	healthy
ctl.y3_AGAACTTCC.ACGATGAAT.AAATTACAG	healthy
ctl.y3_AAGCTCAAC.CGCTAAGCA.AAGGGAACT	healthy
ctl.y3_AGCCATCAC.GCTAACTCA.TGAAGCCAA	healthy
ctl.y3_AGCCATCAC.CAGCACTTC.GATGGTCCA	healthy
ctl.y3_AACGAGAAG.ACGCGAAGC.GGCACAACA	healthy
ctl.y3_AGAGCTATG.AACCCTCGG.GCTCCTTGA	healthy
ctl.y3_TGTACCTTA.GCCTGTTCA.GATCTCTTA	healthy
ctl.y3_TGTACCTTA.ACCTGAGTC.CGTACTACG	healthy
ctl.y3_TCAGGAGGA.TCATTGAGA.CGTACTACG	healthy
ctl.y3_ACAAGGATC.CAAGACCTA.ATGGGACTC	healthy
ctl.y3_TATGTGGCA.CAATTGATC.GTCTTGGCA	healthy
ctl.y3_ATAGACGAG.GCCTGTTCA.AGTTGCATC	healthy
ctl.y3_ATTTAGATG.TTGGAGGTA.CAAACGTGG	healthy
ctl.y3_GGCAAGCAA.TCATCCTAA.TCCTCAATA	healthy
ctl.y3_GGCAAGCAA.TAGAACACA.CTAGATAGA	healthy
ctl.y3_ATGTAATGG.CCATGCACA.CATGAATGA	healthy
